"driver_id","total_rides","total_users","rides_completed","rides_canceled","reviews","avg_ratings"
"100349","8","8","8","0","1","5.00"
"100360","9","9","8","1","1","5.00"
"101070","5","5","4","1","1","5.00"
"101755","6","6","4","2","1","5.00"
"101954","3","3","3","0","1","5.00"
"102261","7","7","4","3","1","5.00"
"103129","9","9","5","4","2","5.00"
"103422","9","9","6","3","4","5.00"
"103927","14","14","10","4","5","5.00"
"104391","8","8","7","1","5","5.00"
"106361","12","12","11","1","4","5.00"
"107206","6","6","6","0","3","5.00"
"107254","11","11","6","5","2","5.00"
"108785","9","9","6","3","3","5.00"
"111777","8","8","8","0","5","5.00"
"113708","8","8","8","0","4","5.00"
"114357","9","9","9","0","6","5.00"
"117611","2","2","2","0","1","5.00"
"113218","14","14","13","1","7","4.92"
"116050","12","12","9","3","5","4.88"
"112440","7","7","6","1","4","4.84"
"101369","11","11","11","0","7","4.83"
"116706","8","8","7","1","4","4.83"
"117437","9","9","8","1","4","4.83"
"104760","11","11","10","1","6","4.80"
"104918","14","14","11","3","5","4.80"
"111184","10","10","8","2","7","4.80"
"101836","11","11","11","0","6","4.75"
"103800","7","7","7","0","4","4.75"
"104032","6","6","6","0","4","4.75"
"104582","12","12","7","5","5","4.75"
"105195","8","8","8","0","6","4.75"
"107074","12","12","12","0","8","4.75"
"107127","13","13","12","1","4","4.75"
"107513","7","7","6","1","3","4.75"
"107772","7","7","7","0","4","4.75"
"108426","5","5","4","1","3","4.75"
"110190","14","14","10","4","4","4.75"
"110614","14","14","13","1","6","4.75"
"111085","7","7","6","1","3","4.75"
"114686","11","11","10","1","4","4.75"
"117236","12","12","10","2","5","4.75"
"117286","11","11","9","2","6","4.75"
"105343","14","14","12","2","9","4.72"
"106368","13","13","12","1","8","4.71"
"116281","16","16","16","0","10","4.71"
"104701","18","18","14","4","6","4.70"
"111131","13","13","10","3","6","4.70"
"111474","12","12","10","2","6","4.70"
"112309","13","13","12","1","7","4.70"
"116079","10","10","9","1","8","4.70"
"101291","18","18","17","1","10","4.69"
"100810","9","9","7","2","3","4.67"
"101935","14","14","13","1","7","4.67"
"102041","11","11","11","0","4","4.67"
"103967","6","6","4","2","3","4.67"
"104181","15","15","14","1","7","4.67"
"104280","6","6","4","2","4","4.67"
"104808","5","5","4","1","4","4.67"
"104833","10","10","10","0","3","4.67"
"104861","8","8","8","0","3","4.67"
"105436","12","12","12","0","9","4.67"
"105662","7","7","6","1","4","4.67"
"107807","12","12","8","4","5","4.67"
"110426","12","12","9","3","6","4.67"
"110890","14","14","13","1","4","4.67"
"111075","9","9","9","0","8","4.67"
"111304","10","10","8","2","4","4.67"
"112420","14","14","11","3","8","4.67"
"112764","12","12","9","3","6","4.67"
"113250","7","7","4","3","3","4.67"
"115756","16","16","11","5","7","4.67"
"117473","9","9","6","3","3","4.67"
"117504","12","12","11","1","7","4.67"
"113135","15","15","14","1","11","4.65"
"100817","16","16","14","2","9","4.64"
"100370","13","13","10","3","5","4.63"
"102290","9","9","9","0","5","4.63"
"103627","12","12","12","0","5","4.63"
"106112","13","13","11","2","8","4.63"
"107915","9","9","8","1","5","4.63"
"109714","12","12","8","4","8","4.63"
"111798","9","9","6","3","6","4.63"
"114080","12","12","9","3","5","4.63"
"114878","10","10","9","1","5","4.63"
"115271","10","10","10","0","8","4.63"
"116857","13","13","11","2","7","4.63"
"100024","8","8","8","0","5","4.60"
"100199","11","11","10","1","7","4.60"
"107151","8","8","7","1","6","4.60"
"107347","12","12","11","1","7","4.60"
"111484","10","10","9","1","6","4.60"
"111494","11","11","11","0","6","4.60"
"113072","9","9","9","0","6","4.60"
"114134","9","9","8","1","5","4.60"
"115762","8","8","6","2","6","4.60"
"117488","11","11","9","2","6","4.60"
"101822","10","10","9","1","7","4.58"
"109730","8","8","8","0","6","4.58"
"110512","12","12","12","0","8","4.58"
"110817","9","9","7","2","6","4.58"
"114396","13","13","12","1","7","4.58"
"104196","15","15","12","3","12","4.57"
"109566","12","12","12","0","10","4.57"
"105884","7","7","6","1","5","4.56"
"113186","16","16","16","0","10","4.56"
"103562","13","13","12","1","8","4.55"
"109412","16","16","16","0","13","4.55"
"117039","14","14","13","1","8","4.55"
"101261","14","14","13","1","7","4.54"
"101884","11","11","11","0","9","4.54"
"103022","12","12","9","3","9","4.53"
"103202","13","13","12","1","7","4.53"
"104473","17","17","16","1","8","4.53"
"108382","16","16","14","2","9","4.53"
"113008","17","17","15","2","7","4.53"
"113371","15","15","13","2","11","4.53"
"109374","11","11","11","0","10","4.52"
"112334","17","17","16","1","11","4.52"
"117259","15","15","13","2","9","4.52"
"117363","15","15","12","3","10","4.52"
"100164","12","12","11","1","8","4.50"
"100219","13","13","11","2","4","4.50"
"100256","11","11","8","3","2","4.50"
"100746","13","13","10","3","9","4.50"
"100764","7","7","7","0","5","4.50"
"101723","15","15","13","2","9","4.50"
"102330","4","4","4","0","2","4.50"
"103181","8","8","6","2","6","4.50"
"103209","10","10","9","1","6","4.50"
"103232","13","13","12","1","7","4.50"
"103238","6","6","6","0","2","4.50"
"103833","15","15","12","3","7","4.50"
"104013","10","10","9","1","4","4.50"
"104217","10","10","10","0","6","4.50"
"104315","11","11","9","2","8","4.50"
"104952","19","19","15","4","6","4.50"
"105330","8","8","8","0","4","4.50"
"105412","9","9","9","0","8","4.50"
"105419","12","12","11","1","6","4.50"
"105445","11","11","8","3","2","4.50"
"105534","8","8","6","2","3","4.50"
"106234","8","8","8","0","2","4.50"
"106429","11","11","9","2","3","4.50"
"106458","10","10","9","1","4","4.50"
"106589","12","12","12","0","9","4.50"
"106698","7","7","6","1","4","4.50"
"107118","11","11","10","1","5","4.50"
"107251","11","11","10","1","8","4.50"
"107495","10","10","9","1","7","4.50"
"107843","11","11","8","3","4","4.50"
"108102","12","12","11","1","9","4.50"
"109878","18","18","16","2","11","4.50"
"109916","4","4","4","0","3","4.50"
"109954","8","8","6","2","4","4.50"
"110115","13","13","12","1","9","4.50"
"110161","8","8","8","0","4","4.50"
"110272","9","9","8","1","7","4.50"
"110362","7","7","6","1","5","4.50"
"110516","11","11","10","1","9","4.50"
"110630","3","3","3","0","3","4.50"
"110703","5","5","5","0","4","4.50"
"110943","8","8","5","3","2","4.50"
"111079","12","12","10","2","4","4.50"
"111262","13","13","12","1","4","4.50"
"111547","9","9","7","2","2","4.50"
"111750","9","9","9","0","6","4.50"
"111888","10","10","8","2","5","4.50"
"112185","9","9","8","1","7","4.50"
"112657","9","9","8","1","4","4.50"
"113516","5","5","4","1","3","4.50"
"113972","14","14","12","2","6","4.50"
"114143","7","7","5","2","4","4.50"
"114282","5","5","5","0","4","4.50"
"114462","10","10","9","1","6","4.50"
"114940","13","13","13","0","4","4.50"
"114996","11","11","11","0","7","4.50"
"115476","9","9","8","1","2","4.50"
"115697","11","11","10","1","4","4.50"
"115705","4","4","4","0","2","4.50"
"115862","12","12","11","1","8","4.50"
"116059","7","7","6","1","3","4.50"
"116081","8","8","6","2","3","4.50"
"116366","9","9","9","0","7","4.50"
"116421","7","7","5","2","3","4.50"
"116614","8","8","8","0","5","4.50"
"117357","8","8","8","0","5","4.50"
"117507","14","14","12","2","5","4.50"
"117513","5","5","5","0","4","4.50"
"103410","22","22","21","1","15","4.48"
"101338","11","11","10","1","7","4.47"
"109080","17","17","16","1","13","4.47"
"113405","13","13","11","2","8","4.47"
"107921","18","18","17","1","14","4.46"
"111764","15","15","14","1","7","4.46"
"114790","19","19","16","3","9","4.46"
"100757","19","19","14","5","8","4.45"
"108962","18","18","17","1","11","4.45"
"111892","12","12","10","2","8","4.45"
"114320","11","11","11","0","11","4.45"
"101997","12","12","10","2","8","4.44"
"103281","11","11","10","1","5","4.44"
"106774","16","16","14","2","8","4.44"
"115340","15","15","13","2","8","4.44"
"100138","15","15","15","0","10","4.43"
"102343","11","11","11","0","8","4.43"
"105402","17","17","14","3","8","4.43"
"110277","14","14","11","3","7","4.43"
"113614","14","14","13","1","8","4.43"
"114318","14","14","14","0","13","4.43"
"101071","13","13","13","0","7","4.42"
"102861","12","12","10","2","9","4.42"
"104643","17","17","14","3","10","4.42"
"105502","19","19","15","4","6","4.42"
"105716","11","11","9","2","6","4.42"
"105957","12","12","11","1","7","4.42"
"106261","11","11","11","0","6","4.42"
"109355","12","12","11","1","7","4.42"
"109873","19","18","17","2","9","4.42"
"110919","16","16","14","2","8","4.42"
"112476","11","11","10","1","6","4.42"
"114913","15","15","14","1","7","4.42"
"102183","10","10","9","1","5","4.40"
"102966","11","11","10","1","5","4.40"
"102977","11","11","10","1","5","4.40"
"107264","11","11","10","1","9","4.40"
"108150","8","8","8","0","7","4.40"
"109098","13","13","12","1","6","4.40"
"109165","11","11","10","1","6","4.40"
"109436","14","14","11","3","7","4.40"
"110165","11","11","11","0","6","4.40"
"111031","13","13","11","2","9","4.40"
"111751","11","11","10","1","6","4.40"
"112695","13","13","11","2","8","4.40"
"113144","17","17","15","2","9","4.40"
"114108","13","13","10","3","7","4.40"
"114518","11","11","9","2","6","4.40"
"103841","13","13","13","0","9","4.39"
"107792","14","14","13","1","8","4.39"
"100255","10","10","8","2","5","4.38"
"101031","14","14","13","1","6","4.38"
"101191","9","9","8","1","5","4.38"
"102694","7","7","7","0","5","4.38"
"103134","17","17","14","3","10","4.38"
"104489","8","8","8","0","5","4.38"
"105697","7","7","7","0","6","4.38"
"106697","8","8","8","0","6","4.38"
"107233","9","9","9","0","5","4.38"
"107635","7","7","7","0","5","4.38"
"108120","13","13","11","2","5","4.38"
"109018","21","21","16","5","9","4.38"
"109445","14","14","13","1","6","4.38"
"110113","8","8","7","1","5","4.38"
"110174","12","12","11","1","5","4.38"
"110395","13","13","12","1","5","4.38"
"110475","18","18","18","0","13","4.38"
"110501","8","8","8","0","5","4.38"
"110815","9","9","8","1","5","4.38"
"110835","12","12","9","3","5","4.38"
"112693","15","15","13","2","11","4.38"
"114218","8","8","7","1","5","4.38"
"115106","20","20","19","1","13","4.38"
"116127","7","7","6","1","5","4.38"
"116414","11","11","10","1","5","4.38"
"100433","8","8","8","0","8","4.37"
"108420","12","12","11","1","8","4.37"
"101835","12","12","11","1","9","4.36"
"103643","19","19","17","2","10","4.36"
"104045","14","14","13","1","11","4.36"
"104202","10","10","10","0","8","4.36"
"106397","14","14","13","1","8","4.36"
"108661","16","16","15","1","9","4.36"
"110478","17","17","15","2","10","4.36"
"112600","14","14","14","0","10","4.36"
"114420","17","17","14","3","11","4.36"
"116143","13","13","12","1","8","4.36"
"103427","15","15","14","1","10","4.35"
"107428","19","19","17","2","11","4.35"
"115839","16","16","15","1","10","4.35"
"112569","15","15","14","1","11","4.34"
"113073","9","9","7","2","4","4.34"
"100158","14","14","13","1","8","4.33"
"100329","7","7","6","1","5","4.33"
"100506","11","11","10","1","4","4.33"
"100873","10","10","8","2","4","4.33"
"101231","10","10","10","0","4","4.33"
"101490","6","6","5","1","3","4.33"
"101604","7","7","7","0","3","4.33"
"101936","12","12","10","2","6","4.33"
"101956","19","19","15","4","6","4.33"
"102076","14","14","11","3","5","4.33"
"102650","13","13","10","3","5","4.33"
"103327","17","17","15","2","9","4.33"
"103933","12","12","10","2","6","4.33"
"103979","10","10","10","0","4","4.33"
"104023","12","12","7","5","6","4.33"
"104332","11","11","10","1","6","4.33"
"104942","10","10","10","0","4","4.33"
"105341","9","9","8","1","3","4.33"
"105622","10","10","8","2","4","4.33"
"106088","14","14","14","0","11","4.33"
"106123","11","11","8","3","6","4.33"
"106260","6","6","5","1","4","4.33"
"106295","11","10","11","0","6","4.33"
"106906","6","6","6","0","3","4.33"
"106927","10","10","10","0","4","4.33"
"107128","8","8","6","2","4","4.33"
"107434","13","13","10","3","3","4.33"
"107606","16","16","13","3","11","4.33"
"107889","14","14","13","1","8","4.33"
"108134","14","14","13","1","7","4.33"
"108155","9","9","7","2","7","4.33"
"108834","17","17","16","1","8","4.33"
"108890","11","10","7","4","4","4.33"
"109033","5","5","4","1","3","4.33"
"109359","11","11","10","1","8","4.33"
"110166","12","12","11","1","6","4.33"
"110276","13","13","13","0","9","4.33"
"111134","8","8","7","1","3","4.33"
"111527","10","10","8","2","3","4.33"
"111550","8","8","8","0","6","4.33"
"111640","8","8","8","0","4","4.33"
"112033","7","7","6","1","4","4.33"
"112077","8","8","7","1","3","4.33"
"112099","19","19","15","4","7","4.33"
"112308","10","10","8","2","4","4.33"
"112556","8","8","7","1","5","4.33"
"113341","8","8","8","0","5","4.33"
"113382","10","10","9","1","3","4.33"
"113658","15","15","14","1","9","4.33"
"113940","11","11","10","1","5","4.33"
"114159","12","12","11","1","9","4.33"
"114362","7","7","6","1","3","4.33"
"114580","11","11","10","1","5","4.33"
"114941","8","8","8","0","5","4.33"
"115530","9","9","8","1","5","4.33"
"115748","14","14","12","2","7","4.33"
"115809","9","9","8","1","7","4.33"
"116211","9","9","7","2","3","4.33"
"116216","12","12","12","0","10","4.33"
"117035","8","8","6","2","4","4.33"
"104669","14","14","11","3","9","4.31"
"104958","16","16","14","2","10","4.31"
"107620","16","16","13","3","11","4.31"
"109734","14","14","12","2","7","4.31"
"111736","12","12","12","0","9","4.31"
"113337","14","14","14","0","13","4.31"
"115721","14","14","12","2","7","4.31"
"116780","24","24","20","4","12","4.31"
"100576","14","14","13","1","6","4.30"
"102519","12","12","11","1","8","4.30"
"102720","13","13","13","0","8","4.30"
"104085","11","11","11","0","7","4.30"
"104895","21","21","20","1","14","4.30"
"105510","17","17","15","2","11","4.30"
"105760","9","9","9","0","6","4.30"
"105850","22","22","18","4","13","4.30"
"106257","14","14","12","2","8","4.30"
"106391","10","10","10","0","7","4.30"
"107373","12","12","11","1","7","4.30"
"107690","15","15","11","4","8","4.30"
"108846","9","9","9","0","7","4.30"
"109321","16","16","15","1","6","4.30"
"109520","13","13","11","2","6","4.30"
"109703","11","11","9","2","8","4.30"
"109996","13","13","12","1","8","4.30"
"110736","11","11","11","0","7","4.30"
"110992","12","12","10","2","6","4.30"
"112292","15","14","15","0","10","4.30"
"112921","12","12","12","0","8","4.30"
"113714","16","16","13","3","7","4.30"
"115499","17","17","15","2","10","4.30"
"115672","15","15","11","4","6","4.30"
"116600","13","13","9","4","6","4.30"
"117209","13","13","11","2","6","4.30"
"117279","14","14","12","2","6","4.30"
"117392","11","11","9","2","6","4.30"
"102522","13","13","10","3","7","4.29"
"104497","14","14","14","0","11","4.29"
"104824","13","13","12","1","10","4.29"
"107630","15","15","13","2","12","4.29"
"107814","11","11","10","1","7","4.29"
"108149","14","14","11","3","9","4.29"
"108624","15","15","13","2","10","4.29"
"109273","17","17","17","0","11","4.29"
"109481","18","18","16","2","11","4.29"
"110508","16","16","14","2","10","4.29"
"111469","11","11","11","0","7","4.29"
"112256","14","14","14","0","7","4.29"
"114024","17","17","16","1","11","4.29"
"114291","14","14","12","2","8","4.29"
"102318","18","18","16","2","13","4.28"
"102554","19","19","16","3","12","4.28"
"104213","15","15","14","1","8","4.28"
"108407","13","13","11","2","6","4.28"
"111364","16","16","14","2","10","4.28"
"114614","11","11","11","0","8","4.28"
"115972","15","15","14","1","10","4.28"
"117324","21","21","19","2","15","4.28"
"100356","14","14","12","2","7","4.27"
"102128","9","9","9","0","7","4.27"
"104001","15","15","15","0","11","4.27"
"104271","16","16","13","3","9","4.27"
"104997","16","16","13","3","8","4.27"
"107694","18","18","17","1","10","4.27"
"108213","16","16","14","2","11","4.27"
"110646","10","10","10","0","7","4.27"
"112267","17","17","16","1","11","4.26"
"116393","20","20","19","1","15","4.26"
"117168","17","17","17","0","12","4.26"
"100440","13","13","13","0","7","4.25"
"101135","11","11","9","2","6","4.25"
"101494","18","18","18","0","9","4.25"
"101511","10","10","8","2","5","4.25"
"101524","10","10","8","2","5","4.25"
"101620","12","12","12","0","8","4.25"
"101749","15","15","12","3","4","4.25"
"101886","12","12","9","3","8","4.25"
"102466","11","11","9","2","4","4.25"
"102662","12","12","12","0","8","4.25"
"103003","10","10","9","1","4","4.25"
"103307","13","13","12","1","10","4.25"
"104060","8","8","7","1","4","4.25"
"104112","4","4","4","0","3","4.25"
"104142","8","8","7","1","4","4.25"
"104517","17","17","14","3","9","4.25"
"105038","14","14","13","1","9","4.25"
"105308","5","5","5","0","3","4.25"
"105363","9","9","9","0","4","4.25"
"105986","11","11","8","3","6","4.25"
"106202","19","19","18","1","12","4.25"
"106247","11","11","10","1","8","4.25"
"106282","10","10","10","0","6","4.25"
"106622","11","11","10","1","6","4.25"
"107462","19","19","16","3","10","4.25"
"107558","16","16","13","3","8","4.25"
"107668","14","14","12","2","5","4.25"
"108257","11","11","9","2","6","4.25"
"108259","16","16","13","3","8","4.25"
"108523","9","9","9","0","6","4.25"
"108533","10","10","10","0","6","4.25"
"108744","11","11","11","0","10","4.25"
"108827","10","10","9","1","5","4.25"
"109108","9","9","8","1","6","4.25"
"109287","14","14","9","5","4","4.25"
"109360","10","10","9","1","7","4.25"
"109486","19","19","17","2","9","4.25"
"109559","10","10","9","1","6","4.25"
"109743","20","20","17","3","10","4.25"
"110050","11","11","10","1","6","4.25"
"110720","13","13","8","5","5","4.25"
"110824","10","10","9","1","7","4.25"
"111069","9","9","7","2","4","4.25"
"111257","13","13","12","1","9","4.25"
"111375","14","14","13","1","8","4.25"
"111538","19","19","16","3","9","4.25"
"112376","10","10","9","1","4","4.25"
"112442","10","10","9","1","7","4.25"
"112546","14","14","10","4","7","4.25"
"113137","15","15","13","2","7","4.25"
"113349","11","11","11","0","6","4.25"
"114493","14","14","12","2","9","4.25"
"114644","9","9","7","2","5","4.25"
"114800","8","8","7","1","4","4.25"
"114897","10","10","9","1","4","4.25"
"115147","7","7","7","0","5","4.25"
"115265","9","9","8","1","4","4.25"
"115967","12","12","10","2","5","4.25"
"116132","12","12","12","0","8","4.25"
"116183","11","11","8","3","5","4.25"
"116488","9","9","8","1","5","4.25"
"116578","16","16","13","3","9","4.25"
"116599","10","10","10","0","5","4.25"
"116663","11","11","10","1","7","4.25"
"116682","12","12","11","1","8","4.25"
"116769","12","12","11","1","6","4.25"
"116809","8","8","7","1","4","4.25"
"116964","14","14","11","3","9","4.25"
"116977","6","6","5","1","3","4.25"
"102010","15","15","15","0","11","4.24"
"113844","15","15","13","2","11","4.24"
"101073","12","12","11","1","9","4.23"
"103273","18","18","18","0","13","4.23"
"104010","19","19","18","1","11","4.23"
"104149","16","16","14","2","10","4.23"
"105748","19","19","18","1","11","4.23"
"108508","15","15","14","1","8","4.23"
"112333","17","17","15","2","9","4.23"
"101114","17","17","16","1","11","4.22"
"102066","9","9","8","1","5","4.22"
"102641","14","14","13","1","9","4.22"
"105547","8","8","7","1","5","4.22"
"105846","5","5","5","0","5","4.22"
"106985","12","12","10","2","5","4.22"
"107420","20","20","16","4","13","4.22"
"108315","11","11","11","0","5","4.22"
"109497","17","17","17","0","14","4.22"
"110923","13","13","10","3","5","4.22"
"112408","13","13","10","3","5","4.22"
"115363","18","18","18","0","12","4.22"
"101289","18","18","18","0","10","4.21"
"102565","13","13","12","1","8","4.21"
"102572","15","15","13","2","10","4.21"
"104900","12","12","11","1","9","4.21"
"105672","19","19","18","1","14","4.21"
"105826","11","11","10","1","8","4.21"
"107910","15","15","14","1","10","4.21"
"108097","14","14","12","2","11","4.21"
"108670","17","17","15","2","11","4.21"
"108693","11","11","9","2","8","4.21"
"109882","14","14","12","2","8","4.21"
"112417","24","24","21","3","13","4.21"
"113188","13","13","13","0","9","4.21"
"113633","14","14","11","3","8","4.21"
"115715","17","17","16","1","10","4.21"
"117119","15","15","15","0","10","4.21"
"100094","12","12","11","1","6","4.20"
"100417","12","12","8","4","6","4.20"
"100707","12","12","11","1","8","4.20"
"100763","19","19","16","3","8","4.20"
"101024","10","10","8","2","6","4.20"
"101079","13","13","10","3","7","4.20"
"101669","13","13","12","1","7","4.20"
"101792","17","17","14","3","10","4.20"
"101883","13","13","11","2","7","4.20"
"102402","18","18","15","3","5","4.20"
"103050","11","11","10","1","7","4.20"
"103080","16","16","14","2","6","4.20"
"103779","9","9","9","0","6","4.20"
"104557","12","12","10","2","7","4.20"
"105063","7","7","7","0","5","4.20"
"105407","15","15","14","1","12","4.20"
"105796","10","10","10","0","5","4.20"
"106264","12","12","10","2","5","4.20"
"107131","8","8","7","1","7","4.20"
"107407","17","17","16","1","13","4.20"
"107602","15","15","12","3","8","4.20"
"107626","11","11","10","1","7","4.20"
"107705","9","9","8","1","8","4.20"
"109938","14","14","13","1","7","4.20"
"111492","10","10","9","1","6","4.20"
"111534","14","14","12","2","7","4.20"
"111845","12","12","12","0","6","4.20"
"111915","10","10","10","0","7","4.20"
"112881","12","12","11","1","7","4.20"
"113737","15","15","11","4","7","4.20"
"114340","7","7","7","0","5","4.20"
"114543","16","16","13","3","8","4.20"
"115343","10","10","10","0","7","4.20"
"115966","9","9","8","1","5","4.20"
"116822","15","15","12","3","5","4.20"
"116927","11","11","10","1","8","4.20"
"117044","8","8","8","0","5","4.20"
"117310","11","11","11","0","7","4.20"
"103924","21","21","16","5","9","4.19"
"106077","13","13","11","2","9","4.19"
"106522","14","14","11","3","9","4.19"
"106705","15","15","14","1","9","4.19"
"106768","13","13","11","2","7","4.19"
"108822","21","21","19","2","11","4.19"
"109469","14","14","14","0","8","4.19"
"111195","15","15","15","0","12","4.19"
"111300","18","18","15","3","9","4.19"
"111763","20","20","16","4","14","4.19"
"114532","12","12","11","1","7","4.19"
"100882","14","14","10","4","8","4.17"
"100892","13","13","13","0","9","4.17"
"101011","17","17","17","0","8","4.17"
"101458","15","15","15","0","9","4.17"
"101528","8","8","5","3","4","4.17"
"101751","8","8","8","0","7","4.17"
"101773","10","10","9","1","6","4.17"
"101873","12","12","12","0","8","4.17"
"102534","20","20","17","3","13","4.17"
"102757","17","17","15","2","9","4.17"
"103186","13","13","11","2","8","4.17"
"103342","9","9","9","0","6","4.17"
"103366","16","16","15","1","12","4.17"
"103848","11","11","10","1","4","4.17"
"103864","14","14","12","2","6","4.17"
"103911","11","10","11","0","4","4.17"
"103959","9","9","8","1","4","4.17"
"103997","10","10","8","2","6","4.17"
"104069","17","17","14","3","10","4.17"
"104076","12","12","8","4","4","4.17"
"104160","11","11","10","1","7","4.17"
"104472","7","7","7","0","4","4.17"
"104639","14","14","13","1","9","4.17"
"104736","16","16","12","4","8","4.17"
"105388","8","8","7","1","6","4.17"
"105508","13","13","13","0","10","4.17"
"105615","9","9","8","1","6","4.17"
"105714","19","19","17","2","12","4.17"
"105926","11","11","11","0","9","4.17"
"105938","17","17","16","1","8","4.17"
"105948","13","13","12","1","9","4.17"
"106213","16","16","11","5","8","4.17"
"106356","10","10","8","2","6","4.17"
"106813","14","14","14","0","11","4.17"
"106915","12","12","11","1","7","4.17"
"106966","14","14","13","1","10","4.17"
"107100","10","10","10","0","7","4.17"
"107349","19","19","16","3","12","4.17"
"107598","11","11","9","2","6","4.17"
"108313","14","14","11","3","8","4.17"
"108634","11","11","7","4","6","4.17"
"108756","8","8","7","1","7","4.17"
"109167","8","8","7","1","5","4.17"
"109215","11","11","10","1","4","4.17"
"109760","12","12","12","0","8","4.17"
"109940","12","12","9","3","6","4.17"
"109947","15","15","14","1","9","4.17"
"109961","12","12","9","3","7","4.17"
"111097","14","14","12","2","6","4.17"
"112137","11","11","11","0","6","4.17"
"112250","8","8","8","0","8","4.17"
"112297","11","11","11","0","8","4.17"
"112398","16","16","15","1","9","4.17"
"112604","11","11","8","3","6","4.17"
"113213","8","8","7","1","6","4.17"
"113484","16","16","15","1","12","4.17"
"113929","17","17","16","1","14","4.17"
"113976","23","23","22","1","15","4.17"
"114040","16","16","15","1","11","4.17"
"114046","18","18","12","6","9","4.17"
"114102","7","7","6","1","4","4.17"
"114344","12","12","11","1","6","4.17"
"114844","9","9","9","0","4","4.17"
"114907","7","7","4","3","4","4.17"
"115976","8","8","8","0","5","4.17"
"116383","11","11","11","0","8","4.17"
"116458","15","15","13","2","9","4.17"
"116819","17","17","16","1","10","4.17"
"116924","15","15","14","1","9","4.17"
"117174","10","10","9","1","7","4.17"
"117197","11","11","11","0","6","4.17"
"105704","16","16","16","0","12","4.15"
"106294","14","14","14","0","8","4.15"
"111820","15","15","13","2","11","4.15"
"116418","15","15","14","1","12","4.15"
"116877","15","15","13","2","10","4.15"
"117195","17","17","16","1","11","4.15"
"100303","13","13","12","1","9","4.14"
"100328","14","14","13","1","10","4.14"
"100999","12","12","12","0","10","4.14"
"101081","9","9","9","0","7","4.14"
"101833","15","15","11","4","10","4.14"
"102006","10","10","10","0","8","4.14"
"104516","14","14","13","1","10","4.14"
"105349","13","13","12","1","10","4.14"
"106388","14","14","13","1","8","4.14"
"106652","17","17","15","2","7","4.14"
"107161","8","8","8","0","7","4.14"
"108966","18","18","16","2","9","4.14"
"109598","19","19","17","2","9","4.14"
"109606","13","13","13","0","11","4.14"
"109795","18","18","16","2","12","4.14"
"110053","18","18","16","2","10","4.14"
"110139","13","13","11","2","8","4.14"
"111692","9","9","9","0","7","4.14"
"111783","11","11","10","1","8","4.14"
"113000","16","16","16","0","11","4.14"
"115166","10","10","10","0","8","4.14"
"116959","11","11","11","0","9","4.14"
"117416","15","15","14","1","11","4.14"
"100422","14","14","12","2","9","4.13"
"100680","12","12","9","3","5","4.13"
"101789","12","12","11","1","9","4.13"
"102056","9","9","9","0","7","4.13"
"102339","12","12","12","0","6","4.13"
"102458","15","15","13","2","8","4.13"
"102504","11","11","10","1","6","4.13"
"102576","10","10","7","3","6","4.13"
"102729","13","13","10","3","5","4.13"
"103541","19","19","15","4","6","4.13"
"103706","17","17","13","4","8","4.13"
"103965","14","14","13","1","6","4.13"
"104105","9","9","9","0","5","4.13"
"104121","10","10","8","2","6","4.13"
"104607","7","7","7","0","5","4.13"
"104623","13","13","12","1","6","4.13"
"105710","11","11","11","0","6","4.13"
"105838","12","12","11","1","7","4.13"
"106051","15","15","12","3","5","4.13"
"106719","8","8","8","0","5","4.13"
"106867","7","7","7","0","6","4.13"
"107424","18","18","12","6","7","4.13"
"107950","9","9","9","0","6","4.13"
"108429","13","13","10","3","5","4.13"
"108960","11","11","9","2","8","4.13"
"109219","13","13","11","2","8","4.13"
"109269","17","17","17","0","11","4.13"
"110773","12","12","10","2","5","4.13"
"110827","13","13","12","1","9","4.13"
"110942","11","11","10","1","5","4.13"
"111064","13","13","13","0","5","4.13"
"111347","12","12","10","2","7","4.13"
"111600","14","14","12","2","9","4.13"
"112003","13","13","10","3","7","4.13"
"112066","18","18","18","0","11","4.13"
"112606","11","11","11","0","5","4.13"
"113667","11","11","9","2","5","4.13"
"113826","14","14","14","0","10","4.13"
"114178","8","8","8","0","5","4.13"
"114284","12","12","11","1","8","4.13"
"114795","19","19","17","2","13","4.13"
"115701","10","10","7","3","5","4.13"
"115738","16","16","16","0","10","4.13"
"115949","18","17","16","2","12","4.13"
"115970","8","8","8","0","5","4.13"
"116002","10","10","10","0","7","4.13"
"116377","17","17","15","2","10","4.13"
"116429","20","20","17","3","11","4.13"
"116750","16","16","13","3","8","4.13"
"116871","13","13","7","6","6","4.13"
"117088","14","14","13","1","6","4.13"
"112745","16","16","13","3","10","4.12"
"114666","15","15","15","0","11","4.12"
"100916","19","19","19","0","14","4.11"
"103589","9","9","9","0","7","4.11"
"106309","16","16","14","2","10","4.11"
"106345","9","9","8","1","5","4.11"
"107551","7","7","6","1","5","4.11"
"107601","18","18","16","2","11","4.11"
"108706","21","21","16","5","10","4.11"
"109596","9","9","7","2","5","4.11"
"109745","10","10","8","2","5","4.11"
"111461","11","11","11","0","9","4.11"
"111837","15","15","11","4","7","4.11"
"114933","11","11","9","2","8","4.11"
"115521","15","15","13","2","8","4.11"
"116375","14","14","12","2","8","4.11"
"116545","16","16","15","1","10","4.11"
"116601","9","9","9","0","5","4.11"
"100459","12","12","12","0","7","4.10"
"100573","13","13","10","3","8","4.10"
"101379","9","9","8","1","6","4.10"
"101756","18","18","14","4","7","4.10"
"102197","11","11","10","1","6","4.10"
"102250","14","14","10","4","7","4.10"
"102334","9","9","9","0","6","4.10"
"103096","11","11","11","0","7","4.10"
"103332","14","14","14","0","11","4.10"
"103873","10","10","8","2","7","4.10"
"103964","14","14","12","2","8","4.10"
"104244","18","18","17","1","8","4.10"
"105218","15","15","13","2","7","4.10"
"105564","13","13","13","0","6","4.10"
"105851","13","13","10","3","6","4.10"
"106134","13","13","12","1","6","4.10"
"106315","14","14","13","1","8","4.10"
"106595","17","17","17","0","12","4.10"
"107167","17","17","16","1","12","4.10"
"107477","16","16","15","1","10","4.10"
"107804","11","10","10","1","9","4.10"
"108306","14","14","12","2","6","4.10"
"108774","12","12","11","1","6","4.10"
"109170","12","12","9","3","6","4.10"
"109252","10","10","10","0","8","4.10"
"109446","10","10","8","2","6","4.10"
"110474","16","15","16","0","14","4.10"
"110888","12","12","10","2","8","4.10"
"111473","18","18","16","2","11","4.10"
"111486","15","15","15","0","6","4.10"
"111582","13","13","9","4","7","4.10"
"111771","19","19","18","1","11","4.10"
"111819","16","16","16","0","10","4.10"
"111921","9","9","8","1","7","4.10"
"112081","13","13","11","2","9","4.10"
"112157","9","9","9","0","7","4.10"
"112201","13","13","13","0","7","4.10"
"112727","12","12","12","0","8","4.10"
"112744","12","12","11","1","10","4.10"
"112754","8","8","7","1","6","4.10"
"112810","12","12","12","0","9","4.10"
"112983","10","10","8","2","7","4.10"
"113392","22","22","19","3","13","4.10"
"113688","11","11","10","1","8","4.10"
"113851","23","23","20","3","12","4.10"
"113960","12","12","10","2","7","4.10"
"114857","14","14","11","3","8","4.10"
"117151","10","10","10","0","7","4.10"
"100191","19","19","19","0","13","4.09"
"101587","15","15","15","0","11","4.09"
"102656","17","17","16","1","14","4.09"
"104733","22","22","20","2","13","4.09"
"109138","9","9","8","1","5","4.09"
"117366","18","18","16","2","13","4.09"
"100186","15","15","14","1","10","4.08"
"100491","17","17","16","1","12","4.08"
"101359","12","12","11","1","8","4.08"
"101707","13","13","13","0","8","4.08"
"102156","10","10","9","1","7","4.08"
"102677","10","10","10","0","6","4.08"
"102906","12","12","11","1","8","4.08"
"103923","10","10","10","0","7","4.08"
"104292","15","15","12","3","9","4.08"
"104539","17","17","16","1","11","4.08"
"104823","16","16","14","2","9","4.08"
"104968","16","16","15","1","13","4.08"
"104980","12","12","12","0","9","4.08"
"105235","11","11","11","0","7","4.08"
"105468","12","12","10","2","7","4.08"
"106811","14","14","12","2","8","4.08"
"107126","13","13","11","2","6","4.08"
"107307","13","13","11","2","11","4.08"
"107935","13","13","10","3","7","4.08"
"108203","17","17","16","1","11","4.08"
"108380","12","12","11","1","7","4.08"
"108979","12","12","10","2","7","4.08"
"109253","12","12","12","0","8","4.08"
"109624","14","14","14","0","7","4.08"
"109871","12","12","11","1","8","4.08"
"110748","16","16","14","2","7","4.08"
"110880","16","16","14","2","8","4.08"
"111341","15","15","11","4","9","4.08"
"111618","7","7","6","1","6","4.08"
"111687","14","14","14","0","8","4.08"
"111734","20","20","19","1","10","4.08"
"111806","19","19","19","0","14","4.08"
"111968","17","17","16","1","8","4.08"
"112748","20","20","16","4","12","4.08"
"112816","12","12","12","0","8","4.08"
"113031","16","16","15","1","8","4.08"
"114086","13","13","9","4","7","4.08"
"114221","12","12","11","1","7","4.08"
"114492","12","12","11","1","9","4.08"
"114685","10","10","8","2","8","4.08"
"114730","10","10","7","3","6","4.08"
"114966","17","17","16","1","9","4.08"
"115195","26","26","23","3","15","4.08"
"115208","18","18","17","1","11","4.08"
"115820","10","10","10","0","7","4.08"
"115852","15","15","12","3","10","4.08"
"115917","14","14","12","2","9","4.08"
"115935","9","9","7","2","6","4.08"
"117069","9","9","7","2","6","4.08"
"117362","13","13","10","3","7","4.08"
"101650","9","9","9","0","8","4.07"
"102325","15","15","13","2","10","4.07"
"102502","16","16","12","4","8","4.07"
"102556","14","14","14","0","12","4.07"
"103138","15","15","14","1","8","4.07"
"103304","16","16","14","2","10","4.07"
"103707","15","15","14","1","10","4.07"
"104775","12","12","10","2","7","4.07"
"105981","16","16","12","4","10","4.07"
"106431","13","13","12","1","8","4.07"
"107191","14","14","13","1","8","4.07"
"107309","15","15","15","0","9","4.07"
"108100","15","15","14","1","8","4.07"
"109838","15","15","14","1","9","4.07"
"109856","12","12","11","1","8","4.07"
"111708","14","14","13","1","12","4.07"
"112231","11","11","10","1","7","4.07"
"112872","17","17","15","2","8","4.07"
"113027","20","20","17","3","11","4.07"
"113214","19","19","13","6","10","4.07"
"113871","13","13","11","2","10","4.07"
"115044","10","10","8","2","8","4.07"
"115054","9","9","7","2","7","4.07"
"115177","12","12","10","2","7","4.07"
"115775","16","16","14","2","10","4.07"
"116299","15","15","13","2","9","4.07"
"116501","15","15","14","1","9","4.07"
"116657","16","16","15","1","9","4.07"
"117175","16","16","15","1","8","4.07"
"117384","18","18","16","2","8","4.07"
"100243","12","12","10","2","8","4.06"
"100411","17","17","15","2","13","4.06"
"100837","14","14","14","0","7","4.06"
"101248","12","12","11","1","9","4.06"
"101352","10","10","10","0","8","4.06"
"102051","14","14","10","4","10","4.06"
"102599","16","16","15","1","10","4.06"
"102855","18","18","15","3","10","4.06"
"103523","15","15","14","1","12","4.06"
"104413","17","17","16","1","10","4.06"
"106263","18","18","13","5","9","4.06"
"107689","13","13","13","0","10","4.06"
"108127","17","17","17","0","13","4.06"
"108516","15","15","14","1","11","4.06"
"109100","9","8","9","0","8","4.06"
"109226","16","16","16","0","12","4.06"
"109463","14","14","13","1","11","4.06"
"109608","10","10","10","0","9","4.06"
"110215","21","21","20","1","16","4.06"
"110941","19","19","18","1","12","4.06"
"111613","17","17","15","2","12","4.06"
"111641","26","26","25","1","18","4.06"
"111885","13","13","13","0","12","4.06"
"112152","18","18","16","2","10","4.06"
"112399","18","18","16","2","10","4.06"
"113835","19","19","17","2","12","4.06"
"115193","20","20","19","1","17","4.06"
"116000","19","19","16","3","15","4.06"
"117359","20","20","19","1","10","4.06"
"101666","13","13","12","1","10","4.05"
"102452","19","19","17","2","13","4.05"
"104963","14","14","13","1","9","4.05"
"107802","21","21","17","4","11","4.05"
"109700","11","11","11","0","10","4.05"
"111938","18","18","15","3","12","4.05"
"101670","14","14","12","2","11","4.04"
"102242","19","19","16","3","10","4.04"
"103004","18","18","16","2","9","4.04"
"104100","13","13","13","0","7","4.04"
"104710","18","18","16","2","13","4.04"
"106272","11","11","11","0","7","4.04"
"107659","13","13","12","1","7","4.04"
"108982","14","14","14","0","13","4.04"
"114105","13","13","11","2","9","4.04"
"114950","15","15","14","1","14","4.04"
"100268","15","15","11","4","10","4.03"
"101103","20","20","17","3","13","4.03"
"101879","18","18","15","3","11","4.03"
"105276","18","18","15","3","12","4.03"
"105728","19","19","19","0","11","4.03"
"106918","15","15","13","2","8","4.03"
"107164","11","11","10","1","8","4.03"
"108750","21","21","18","3","10","4.03"
"111138","17","17","14","3","8","4.03"
"111549","18","18","17","1","11","4.03"
"112537","13","13","13","0","8","4.03"
"113375","13","13","11","2","8","4.03"
"113468","12","12","10","2","9","4.03"
"115753","15","15","15","0","13","4.03"
"115878","20","20","18","2","14","4.03"
"102383","17","17","16","1","12","4.02"
"103378","14","14","13","1","12","4.02"
"103386","19","19","17","2","13","4.02"
"103922","19","19","17","2","15","4.02"
"103943","16","16","15","1","11","4.02"
"106357","19","19","17","2","13","4.02"
"108211","20","20","18","2","12","4.02"
"108949","17","17","17","0","13","4.02"
"110093","15","15","14","1","10","4.02"
"110883","28","28","26","2","19","4.02"
"102420","14","14","13","1","11","4.01"
"100085","20","20","16","4","8","4.00"
"100117","25","25","22","3","12","4.00"
"100144","9","9","6","3","2","4.00"
"100173","9","9","8","1","5","4.00"
"100174","11","11","8","3","6","4.00"
"100272","15","15","13","2","7","4.00"
"100416","10","10","9","1","6","4.00"
"100427","14","14","13","1","10","4.00"
"100509","6","6","6","0","2","4.00"
"100550","11","11","10","1","3","4.00"
"100556","20","20","18","2","10","4.00"
"100677","8","8","6","2","5","4.00"
"100797","9","9","9","0","6","4.00"
"100801","12","12","11","1","7","4.00"
"100910","12","12","9","3","2","4.00"
"101052","11","11","9","2","6","4.00"
"101080","16","16","13","3","7","4.00"
"101083","13","13","12","1","9","4.00"
"101155","14","14","12","2","7","4.00"
"101190","8","8","8","0","4","4.00"
"101246","10","10","9","1","6","4.00"
"101272","13","13","13","0","11","4.00"
"101304","10","10","9","1","8","4.00"
"101372","10","10","9","1","5","4.00"
"101479","16","16","15","1","9","4.00"
"101486","8","8","6","2","4","4.00"
"101507","9","9","7","2","3","4.00"
"101519","11","11","10","1","6","4.00"
"101592","11","11","11","0","7","4.00"
"101706","7","7","7","0","1","4.00"
"101715","11","11","11","0","8","4.00"
"101743","12","12","11","1","9","4.00"
"101794","8","8","7","1","7","4.00"
"101799","15","15","13","2","7","4.00"
"101803","15","15","13","2","8","4.00"
"101889","11","11","8","3","5","4.00"
"101996","16","16","15","1","5","4.00"
"102094","14","14","11","3","9","4.00"
"102120","4","4","3","1","3","4.00"
"102142","7","7","7","0","3","4.00"
"102186","10","10","9","1","4","4.00"
"102306","12","12","11","1","10","4.00"
"102348","11","11","9","2","6","4.00"
"102390","10","10","9","1","7","4.00"
"102395","7","7","6","1","3","4.00"
"102601","9","9","6","3","4","4.00"
"102669","8","8","8","0","7","4.00"
"102685","6","6","4","2","3","4.00"
"102710","18","18","17","1","13","4.00"
"102711","12","12","10","2","7","4.00"
"102793","14","14","13","1","6","4.00"
"102800","12","12","9","3","8","4.00"
"102847","12","12","11","1","7","4.00"
"102891","9","9","8","1","6","4.00"
"102922","15","15","14","1","7","4.00"
"102950","13","13","12","1","3","4.00"
"102989","13","13","12","1","8","4.00"
"102999","7","7","7","0","5","4.00"
"103044","10","10","10","0","8","4.00"
"103150","11","11","7","4","7","4.00"
"103220","14","14","12","2","7","4.00"
"103231","9","9","8","1","5","4.00"
"103258","14","14","12","2","2","4.00"
"103397","10","10","8","2","6","4.00"
"103543","10","10","8","2","5","4.00"
"103546","10","10","9","1","5","4.00"
"103742","19","19","16","3","8","4.00"
"103808","17","17","15","2","13","4.00"
"103872","13","13","11","2","7","4.00"
"104049","21","21","18","3","6","4.00"
"104082","7","7","7","0","6","4.00"
"104229","5","5","2","3","1","4.00"
"104237","10","10","10","0","6","4.00"
"104264","13","13","12","1","9","4.00"
"104420","7","7","4","3","4","4.00"
"104440","13","13","9","4","8","4.00"
"104445","10","10","9","1","6","4.00"
"104630","13","13","13","0","9","4.00"
"104679","6","6","5","1","3","4.00"
"104727","15","15","12","3","9","4.00"
"104755","11","11","9","2","7","4.00"
"104819","10","10","9","1","9","4.00"
"104849","10","10","10","0","6","4.00"
"104863","12","12","12","0","9","4.00"
"104899","17","17","16","1","12","4.00"
"104909","7","7","6","1","1","4.00"
"104910","17","17","16","1","9","4.00"
"104959","12","12","10","2","4","4.00"
"104971","8","8","7","1","5","4.00"
"104976","18","18","16","2","9","4.00"
"105010","13","13","12","1","7","4.00"
"105025","13","13","9","4","6","4.00"
"105064","6","6","5","1","4","4.00"
"105085","12","12","12","0","9","4.00"
"105151","10","10","9","1","5","4.00"
"105328","8","8","6","2","3","4.00"
"105337","10","10","9","1","8","4.00"
"105433","17","17","17","0","8","4.00"
"105475","9","9","9","0","7","4.00"
"105519","8","8","8","0","6","4.00"
"105688","12","12","10","2","1","4.00"
"105695","6","6","6","0","3","4.00"
"105779","11","11","10","1","7","4.00"
"105879","13","13","10","3","5","4.00"
"105955","10","10","10","0","7","4.00"
"105968","15","15","12","3","9","4.00"
"105977","16","16","13","3","8","4.00"
"106033","9","9","8","1","5","4.00"
"106107","13","13","12","1","9","4.00"
"106115","11","11","8","3","5","4.00"
"106218","10","10","9","1","3","4.00"
"106221","14","14","12","2","8","4.00"
"106232","14","14","12","2","6","4.00"
"106275","20","20","19","1","12","4.00"
"106348","19","19","17","2","10","4.00"
"106383","13","13","10","3","5","4.00"
"106420","4","4","4","0","2","4.00"
"106464","6","6","6","0","6","4.00"
"106971","14","14","13","1","7","4.00"
"107051","19","19","17","2","13","4.00"
"107144","10","10","9","1","7","4.00"
"107227","14","14","13","1","9","4.00"
"107352","9","9","7","2","5","4.00"
"107364","12","12","11","1","4","4.00"
"107468","13","13","11","2","8","4.00"
"107503","11","11","9","2","3","4.00"
"107546","13","13","9","4","6","4.00"
"107584","11","11","9","2","7","4.00"
"107593","10","10","7","3","6","4.00"
"107657","10","10","6","4","3","4.00"
"107704","13","13","12","1","6","4.00"
"107881","10","10","10","0","7","4.00"
"107900","14","14","13","1","7","4.00"
"108002","12","12","11","1","6","4.00"
"108050","13","13","13","0","8","4.00"
"108110","16","16","14","2","8","4.00"
"108119","17","17","15","2","9","4.00"
"108180","7","7","7","0","5","4.00"
"108241","10","10","10","0","8","4.00"
"108285","16","16","13","3","10","4.00"
"108287","12","12","10","2","7","4.00"
"108312","12","12","12","0","7","4.00"
"108318","8","8","7","1","6","4.00"
"108361","8","8","7","1","3","4.00"
"108452","9","9","7","2","1","4.00"
"108472","15","15","12","3","8","4.00"
"108475","11","11","10","1","8","4.00"
"108502","10","10","10","0","5","4.00"
"108528","6","6","4","2","2","4.00"
"108541","15","15","12","3","4","4.00"
"108548","12","12","10","2","4","4.00"
"108590","12","12","11","1","3","4.00"
"108640","11","11","11","0","9","4.00"
"108688","15","15","15","0","10","4.00"
"108704","8","8","7","1","5","4.00"
"108709","9","9","6","3","3","4.00"
"108762","13","13","11","2","5","4.00"
"108782","11","11","9","2","5","4.00"
"108786","9","9","8","1","3","4.00"
"108819","11","11","9","2","7","4.00"
"108886","8","8","8","0","6","4.00"
"108954","11","11","11","0","8","4.00"
"109074","9","9","8","1","3","4.00"
"109159","9","9","9","0","7","4.00"
"109187","11","11","11","0","6","4.00"
"109200","11","11","7","4","4","4.00"
"109206","9","9","8","1","5","4.00"
"109220","17","17","14","3","9","4.00"
"109299","5","5","4","1","3","4.00"
"109330","25","25","24","1","16","4.00"
"109348","6","6","3","3","2","4.00"
"109450","9","9","7","2","4","4.00"
"109631","12","12","10","2","5","4.00"
"109651","12","12","11","1","6","4.00"
"109712","13","13","8","5","2","4.00"
"109737","18","18","14","4","7","4.00"
"109901","9","9","9","0","6","4.00"
"109933","20","20","19","1","11","4.00"
"109949","6","6","5","1","1","4.00"
"110179","11","11","10","1","6","4.00"
"110211","7","7","7","0","3","4.00"
"110235","13","13","13","0","7","4.00"
"110288","19","19","17","2","11","4.00"
"110407","10","10","8","2","5","4.00"
"110454","14","14","11","3","6","4.00"
"110520","8","8","7","1","4","4.00"
"110638","13","13","12","1","7","4.00"
"110651","14","14","12","2","7","4.00"
"110701","12","12","8","4","5","4.00"
"110731","11","11","10","1","7","4.00"
"110790","14","14","11","3","6","4.00"
"110793","9","9","9","0","7","4.00"
"110797","22","22","18","4","12","4.00"
"110878","15","15","14","1","8","4.00"
"111051","15","15","10","5","8","4.00"
"111145","18","18","18","0","10","4.00"
"111179","11","11","11","0","4","4.00"
"111211","13","13","12","1","8","4.00"
"111365","10","10","10","0","9","4.00"
"111403","10","10","9","1","5","4.00"
"111701","6","6","5","1","4","4.00"
"111728","9","9","7","2","3","4.00"
"111906","13","13","11","2","6","4.00"
"111983","8","8","8","0","8","4.00"
"112025","7","7","6","1","6","4.00"
"112108","12","12","11","1","8","4.00"
"112142","13","13","12","1","6","4.00"
"112155","15","15","12","3","6","4.00"
"112226","12","12","10","2","5","4.00"
"112260","8","8","6","2","3","4.00"
"112287","22","22","20","2","14","4.00"
"112291","11","11","11","0","6","4.00"
"112348","12","12","12","0","10","4.00"
"112389","12","12","11","1","9","4.00"
"112390","11","11","11","0","9","4.00"
"112642","4","4","4","0","3","4.00"
"112711","15","15","14","1","8","4.00"
"112730","7","7","7","0","2","4.00"
"112743","12","12","10","2","7","4.00"
"112756","13","13","12","1","11","4.00"
"112863","15","15","15","0","7","4.00"
"113004","11","11","9","2","3","4.00"
"113014","14","14","11","3","7","4.00"
"113094","9","9","8","1","7","4.00"
"113336","6","6","4","2","3","4.00"
"113403","14","14","13","1","8","4.00"
"113470","11","11","10","1","5","4.00"
"113473","10","10","10","0","6","4.00"
"113503","14","14","12","2","6","4.00"
"113575","16","16","14","2","10","4.00"
"113618","10","10","7","3","3","4.00"
"113656","11","11","11","0","6","4.00"
"113757","14","14","14","0","11","4.00"
"113994","12","12","11","1","5","4.00"
"114050","10","10","10","0","4","4.00"
"114111","7","7","7","0","4","4.00"
"114157","8","8","6","2","3","4.00"
"114210","11","11","9","2","6","4.00"
"114216","4","4","3","1","2","4.00"
"114220","5","5","5","0","2","4.00"
"114296","12","12","12","0","8","4.00"
"114297","13","13","11","2","7","4.00"
"114358","19","19","18","1","12","4.00"
"114388","15","15","13","2","9","4.00"
"114397","14","14","13","1","7","4.00"
"114437","8","8","8","0","5","4.00"
"114517","10","10","10","0","7","4.00"
"114697","17","17","14","3","7","4.00"
"114714","14","14","10","4","7","4.00"
"114719","18","18","17","1","12","4.00"
"114768","10","10","9","1","6","4.00"
"114810","15","15","13","2","8","4.00"
"114835","11","11","10","1","6","4.00"
"114886","9","9","9","0","9","4.00"
"114923","8","8","5","3","4","4.00"
"114985","10","10","10","0","6","4.00"
"115009","13","13","12","1","6","4.00"
"115023","15","15","14","1","4","4.00"
"115165","12","12","8","4","8","4.00"
"115207","15","15","15","0","9","4.00"
"115276","5","5","5","0","1","4.00"
"115291","17","17","16","1","10","4.00"
"115301","12","12","11","1","7","4.00"
"115398","14","14","13","1","8","4.00"
"115456","8","8","6","2","1","4.00"
"115475","13","13","12","1","8","4.00"
"115515","13","13","12","1","8","4.00"
"115544","12","12","12","0","9","4.00"
"115568","7","7","6","1","4","4.00"
"115569","12","12","11","1","10","4.00"
"115640","14","14","13","1","8","4.00"
"115763","13","13","10","3","3","4.00"
"115857","10","10","9","1","5","4.00"
"115918","10","10","9","1","9","4.00"
"115968","7","7","6","1","6","4.00"
"116054","9","9","9","0","7","4.00"
"116084","13","13","13","0","10","4.00"
"116162","14","14","13","1","10","4.00"
"116175","12","12","9","3","5","4.00"
"116180","10","10","9","1","4","4.00"
"116233","10","10","10","0","8","4.00"
"116323","9","9","9","0","5","4.00"
"116462","14","14","10","4","7","4.00"
"116517","9","9","8","1","4","4.00"
"116547","12","12","10","2","5","4.00"
"116573","10","10","7","3","4","4.00"
"116591","10","10","9","1","6","4.00"
"116631","9","9","9","0","5","4.00"
"116666","12","12","9","3","5","4.00"
"116668","11","11","11","0","10","4.00"
"116759","13","13","11","2","7","4.00"
"116883","14","14","13","1","7","4.00"
"117091","16","16","16","0","9","4.00"
"117187","9","9","7","2","5","4.00"
"117225","6","6","5","1","2","4.00"
"117307","12","12","9","3","7","4.00"
"117319","12","12","11","1","7","4.00"
"117339","13","13","13","0","10","4.00"
"117413","14","14","13","1","7","4.00"
"117485","9","9","9","0","7","4.00"
"117510","14","14","14","0","10","4.00"
"117536","7","7","6","1","3","4.00"
"101389","19","19","17","2","11","3.98"
"105327","16","16","15","1","12","3.98"
"105654","16","16","15","1","12","3.98"
"105870","20","20","20","0","16","3.98"
"105996","12","12","11","1","9","3.98"
"110609","15","15","14","1","11","3.98"
"112457","18","18","16","2","11","3.98"
"112806","18","18","15","3","10","3.98"
"105476","10","10","9","1","9","3.97"
"107404","19","19","17","2","14","3.97"
"110509","14","14","14","0","9","3.97"
"111373","11","11","11","0","9","3.97"
"111700","15","15","14","1","8","3.97"
"113123","18","18","17","1","13","3.97"
"113513","18","18","18","0","12","3.97"
"116841","13","13","13","0","9","3.97"
"101708","22","22","20","2","13","3.96"
"102342","17","17","15","2","13","3.96"
"102392","17","17","16","1","13","3.96"
"102940","13","13","13","0","11","3.96"
"103573","13","13","12","1","9","3.96"
"104872","17","17","15","2","10","3.96"
"105491","20","20","19","1","13","3.96"
"105583","17","17","16","1","13","3.96"
"106052","18","18","17","1","13","3.96"
"107250","11","11","10","1","7","3.96"
"107478","15","15","14","1","7","3.96"
"107733","18","18","16","2","10","3.96"
"109953","12","12","12","0","10","3.96"
"111173","12","12","10","2","7","3.96"
"114451","11","11","11","0","9","3.96"
"115843","19","19","19","0","13","3.96"
"116667","13","13","13","0","10","3.96"
"117521","19","19","19","0","14","3.96"
"100322","14","14","12","2","8","3.95"
"101023","19","19","19","0","16","3.95"
"101696","13","13","12","1","8","3.95"
"102859","12","12","12","0","10","3.95"
"104990","12","12","11","1","10","3.95"
"106898","11","11","9","2","8","3.95"
"107175","17","17","15","2","10","3.95"
"107880","17","17","16","1","8","3.95"
"108014","14","14","14","0","8","3.95"
"109290","16","16","15","1","9","3.95"
"110670","11","11","11","0","9","3.95"
"111289","21","21","18","3","12","3.95"
"111345","18","18","15","3","10","3.95"
"111459","21","21","18","3","11","3.95"
"112002","16","16","15","1","9","3.95"
"112323","18","18","14","4","12","3.95"
"113141","15","15","14","1","8","3.95"
"113279","12","12","12","0","9","3.95"
"114640","18","18","17","1","14","3.95"
"115421","11","11","10","1","8","3.95"
"115535","10","10","10","0","9","3.95"
"115650","13","13","12","1","9","3.95"
"115905","11","11","10","1","8","3.95"
"117609","20","20","18","2","12","3.95"
"100401","16","16","14","2","10","3.94"
"101311","14","14","13","1","7","3.94"
"101994","15","15","13","2","10","3.94"
"102296","18","18","17","1","13","3.94"
"102927","18","18","18","0","14","3.94"
"102960","16","16","16","0","10","3.94"
"103054","23","23","22","1","16","3.94"
"103777","22","22","20","2","16","3.94"
"103783","20","20","19","1","15","3.94"
"104783","14","14","13","1","10","3.94"
"105239","14","14","13","1","11","3.94"
"106283","21","21","17","4","11","3.94"
"107001","14","14","13","1","9","3.94"
"107223","12","12","12","0","8","3.94"
"107300","16","16","15","1","10","3.94"
"107588","23","23","20","3","14","3.94"
"107658","11","11","10","1","9","3.94"
"107760","18","18","14","4","10","3.94"
"109455","21","21","20","1","13","3.94"
"109669","20","20","16","4","11","3.94"
"110274","17","17","16","1","12","3.94"
"111417","16","16","16","0","13","3.94"
"112391","18","18","16","2","11","3.94"
"113130","13","13","11","2","10","3.94"
"113977","18","18","17","1","13","3.94"
"114976","17","17","17","0","9","3.94"
"115492","20","20","17","3","8","3.94"
"116357","16","16","16","0","12","3.94"
"116481","18","18","17","1","12","3.94"
"116546","8","8","7","1","6","3.94"
"116652","13","13","12","1","12","3.94"
"116722","17","17","15","2","12","3.94"
"116926","12","12","10","2","7","3.94"
"100448","21","21","20","1","16","3.93"
"101617","15","15","14","1","8","3.93"
"101700","16","16","13","3","11","3.93"
"101951","13","13","11","2","8","3.93"
"102524","17","17","16","1","11","3.93"
"102837","13","13","11","2","9","3.93"
"102954","11","11","11","0","9","3.93"
"104502","12","12","11","1","9","3.93"
"104856","16","16","14","2","9","3.93"
"104972","16","16","14","2","9","3.93"
"105133","19","19","16","3","11","3.93"
"105288","16","16","15","1","10","3.93"
"105787","12","12","10","2","8","3.93"
"106022","14","14","12","2","8","3.93"
"106244","15","15","13","2","9","3.93"
"106310","16","16","15","1","10","3.93"
"106618","13","13","13","0","10","3.93"
"107735","11","11","11","0","9","3.93"
"107799","12","12","10","2","7","3.93"
"108165","14","14","13","1","8","3.93"
"108847","15","15","15","0","9","3.93"
"108856","14","14","13","1","8","3.93"
"109414","14","14","14","0","9","3.93"
"109434","18","18","13","5","10","3.93"
"109440","13","13","12","1","9","3.93"
"110028","13","13","10","3","10","3.93"
"110871","12","12","11","1","7","3.93"
"110928","17","17","16","1","9","3.93"
"110994","18","18","15","3","11","3.93"
"111083","12","12","9","3","8","3.93"
"111086","11","11","11","0","8","3.93"
"111632","23","23","21","2","9","3.93"
"111765","16","16","14","2","9","3.93"
"112178","21","21","17","4","11","3.93"
"113427","12","12","12","0","7","3.93"
"113925","12","12","10","2","7","3.93"
"113961","16","16","15","1","13","3.93"
"114180","11","11","9","2","7","3.93"
"114328","13","13","12","1","10","3.93"
"114594","11","11","9","2","8","3.93"
"114759","20","20","16","4","8","3.93"
"115656","22","22","20","2","15","3.93"
"115765","16","16","14","2","9","3.93"
"115789","14","14","12","2","10","3.93"
"116463","16","16","15","1","10","3.93"
"116679","13","13","13","0","8","3.93"
"117583","16","16","12","4","10","3.93"
"100010","11","11","9","2","7","3.92"
"100188","14","14","14","0","8","3.92"
"100936","17","17","16","1","9","3.92"
"101057","13","13","12","1","9","3.92"
"101072","9","9","9","0","6","3.92"
"101310","10","10","10","0","8","3.92"
"102044","7","7","7","0","6","3.92"
"102545","18","18","13","5","10","3.92"
"102590","16","16","16","0","12","3.92"
"102626","17","17","17","0","9","3.92"
"102783","13","13","12","1","7","3.92"
"103146","10","10","9","1","7","3.92"
"103520","19","19","19","0","11","3.92"
"103580","10","10","9","1","7","3.92"
"103637","17","17","17","0","12","3.92"
"103671","9","9","7","2","7","3.92"
"103805","9","9","9","0","7","3.92"
"103913","14","14","13","1","8","3.92"
"104373","17","17","13","4","10","3.92"
"104515","12","12","10","2","8","3.92"
"104596","9","9","9","0","7","3.92"
"104722","13","13","11","2","9","3.92"
"105016","10","10","9","1","8","3.92"
"105144","18","18","16","2","12","3.92"
"105394","16","16","11","5","7","3.92"
"105585","16","16","15","1","10","3.92"
"105788","12","12","11","1","8","3.92"
"105898","15","15","14","1","11","3.92"
"106081","12","12","10","2","8","3.92"
"106735","16","16","14","2","10","3.92"
"106781","12","12","9","3","8","3.92"
"107229","18","18","18","0","13","3.92"
"107402","12","12","12","0","8","3.92"
"107421","17","17","15","2","12","3.92"
"108439","15","15","14","1","10","3.92"
"108763","19","19","18","1","11","3.92"
"109311","10","10","8","2","7","3.92"
"109347","17","17","15","2","7","3.92"
"109588","9","9","9","0","8","3.92"
"109594","14","14","12","2","9","3.92"
"109701","10","10","9","1","8","3.92"
"110019","11","11","11","0","7","3.92"
"110853","14","14","12","2","8","3.92"
"111025","9","9","8","1","6","3.92"
"111309","10","10","10","0","6","3.92"
"112224","12","12","10","2","6","3.92"
"112593","13","13","13","0","10","3.92"
"112791","13","13","11","2","6","3.92"
"113108","13","13","12","1","7","3.92"
"113312","20","20","18","2","15","3.92"
"114008","10","10","10","0","7","3.92"
"114334","13","13","13","0","8","3.92"
"114379","17","17","17","0","10","3.92"
"114671","15","15","13","2","8","3.92"
"114841","11","11","11","0","9","3.92"
"114922","19","19","18","1","12","3.92"
"115206","18","18","16","2","10","3.92"
"115957","12","12","11","1","8","3.92"
"116331","16","16","13","3","9","3.92"
"116610","17","17","17","0","15","3.92"
"116851","13","13","11","2","7","3.92"
"117029","17","17","17","0","14","3.92"
"117071","16","16","14","2","10","3.92"
"117249","15","15","14","1","10","3.92"
"117290","13","13","11","2","6","3.92"
"117539","19","19","14","5","9","3.92"
"109474","21","21","20","1","15","3.91"
"117520","17","17","15","2","13","3.91"
"100159","9","9","8","1","6","3.90"
"100324","9","9","8","1","7","3.90"
"100365","18","18","13","5","6","3.90"
"100466","15","15","13","2","8","3.90"
"100980","15","15","12","3","7","3.90"
"101018","21","21","20","1","9","3.90"
"101448","17","17","15","2","11","3.90"
"101893","15","15","12","3","10","3.90"
"102391","12","12","11","1","7","3.90"
"102468","10","10","10","0","7","3.90"
"102655","10","10","9","1","6","3.90"
"102926","14","14","13","1","9","3.90"
"103093","14","14","13","1","6","3.90"
"103612","17","17","14","3","8","3.90"
"103861","13","13","12","1","8","3.90"
"104111","15","15","13","2","10","3.90"
"104124","17","17","16","1","13","3.90"
"104514","14","14","8","6","6","3.90"
"104846","15","15","14","1","9","3.90"
"105166","21","21","20","1","14","3.90"
"105293","16","16","15","1","12","3.90"
"105316","12","12","11","1","10","3.90"
"105381","14","14","11","3","9","3.90"
"105708","10","10","7","3","7","3.90"
"105853","7","7","7","0","6","3.90"
"105907","12","12","10","2","7","3.90"
"106079","12","12","12","0","7","3.90"
"106423","11","11","10","1","7","3.90"
"106525","9","9","8","1","6","3.90"
"106648","17","17","17","0","11","3.90"
"106798","12","12","10","2","6","3.90"
"107296","17","17","15","2","12","3.90"
"107331","11","11","11","0","7","3.90"
"108081","14","14","12","2","7","3.90"
"108353","19","19","19","0","15","3.90"
"108490","11","11","10","1","7","3.90"
"108501","14","14","14","0","7","3.90"
"109020","15","15","13","2","7","3.90"
"109696","15","15","12","3","7","3.90"
"109744","20","20","20","0","13","3.90"
"110079","10","10","9","1","7","3.90"
"110158","9","9","8","1","7","3.90"
"110264","12","12","11","1","7","3.90"
"110281","14","14","11","3","6","3.90"
"110400","12","12","11","1","6","3.90"
"110951","12","12","11","1","8","3.90"
"111006","12","12","11","1","7","3.90"
"111349","14","14","13","1","9","3.90"
"111426","17","17","11","6","7","3.90"
"111568","15","15","15","0","9","3.90"
"111684","9","9","8","1","7","3.90"
"112075","15","15","13","2","7","3.90"
"112107","13","13","13","0","11","3.90"
"112126","12","12","12","0","6","3.90"
"112429","17","17","16","1","11","3.90"
"112582","12","12","9","3","6","3.90"
"112602","13","13","11","2","6","3.90"
"112735","23","23","19","4","14","3.90"
"112870","18","18","16","2","13","3.90"
"113055","15","15","13","2","10","3.90"
"113101","11","11","11","0","7","3.90"
"113140","17","17","16","1","8","3.90"
"113391","11","11","10","1","6","3.90"
"114219","13","13","13","0","7","3.90"
"114634","18","18","17","1","13","3.90"
"115033","12","12","11","1","8","3.90"
"115543","18","18","15","3","11","3.90"
"115885","10","10","9","1","8","3.90"
"116731","11","11","10","1","7","3.90"
"116749","18","18","16","2","11","3.90"
"117072","15","15","11","4","7","3.90"
"117149","17","17","16","1","9","3.90"
"117167","14","14","12","2","6","3.90"
"117451","15","15","14","1","8","3.90"
"117553","11","11","10","1","6","3.90"
"100668","9","9","9","0","5","3.89"
"101584","17","17","16","1","11","3.89"
"101655","13","13","12","1","11","3.89"
"102235","15","15","14","1","9","3.89"
"102281","15","15","15","0","8","3.89"
"102659","10","10","9","1","6","3.89"
"103280","9","9","9","0","7","3.89"
"103348","21","21","19","2","13","3.89"
"103455","12","12","9","3","6","3.89"
"104066","15","15","14","1","10","3.89"
"104329","11","11","8","3","5","3.89"
"104520","14","14","12","2","6","3.89"
"106200","13","13","10","3","7","3.89"
"106728","11","11","11","0","8","3.89"
"106853","15","15","15","0","9","3.89"
"107412","18","18","16","2","11","3.89"
"107728","9","9","7","2","5","3.89"
"108139","17","17","16","1","14","3.89"
"108186","14","14","14","0","10","3.89"
"108653","16","16","16","0","11","3.89"
"108791","19","19","17","2","11","3.89"
"109053","17","17","13","4","9","3.89"
"110105","12","12","11","1","9","3.89"
"110381","13","13","12","1","8","3.89"
"110644","24","24","24","0","14","3.89"
"110909","8","8","7","1","6","3.89"
"110984","16","16","16","0","11","3.89"
"111853","12","12","9","3","6","3.89"
"112147","15","15","12","3","7","3.89"
"113625","11","11","10","1","5","3.89"
"114602","14","14","13","1","10","3.89"
"115239","17","17","15","2","12","3.89"
"116520","11","11","10","1","5","3.89"
"116687","11","11","11","0","5","3.89"
"117059","22","22","20","2","13","3.89"
"100092","17","17","15","2","9","3.88"
"100436","15","15","12","3","7","3.88"
"100465","19","19","15","4","11","3.88"
"100477","18","18","17","1","10","3.88"
"100785","6","6","6","0","5","3.88"
"101354","19","19","17","2","13","3.88"
"101440","10","10","9","1","5","3.88"
"101576","19","19","16","3","11","3.88"
"102157","9","9","7","2","5","3.88"
"102223","14","14","9","5","6","3.88"
"102321","14","14","12","2","8","3.88"
"102439","15","15","14","1","11","3.88"
"102445","15","15","15","0","12","3.88"
"102915","15","15","15","0","12","3.88"
"103305","15","15","12","3","8","3.88"
"103488","17","17","17","0","9","3.88"
"103820","10","10","8","2","5","3.88"
"103886","18","18","17","1","14","3.88"
"104056","10","10","10","0","7","3.88"
"104185","19","19","15","4","12","3.88"
"104675","16","16","15","1","10","3.88"
"105657","11","11","9","2","5","3.88"
"105702","10","10","9","1","5","3.88"
"105723","11","11","11","0","6","3.88"
"105896","11","11","9","2","5","3.88"
"106014","10","10","9","1","7","3.88"
"106108","15","15","14","1","9","3.88"
"106171","17","17","12","5","8","3.88"
"106568","13","13","9","4","5","3.88"
"106739","13","13","12","1","7","3.88"
"107440","11","11","10","1","7","3.88"
"107609","12","12","11","1","6","3.88"
"107743","15","15","12","3","5","3.88"
"107794","11","11","8","3","5","3.88"
"108294","16","16","13","3","6","3.88"
"108314","12","12","12","0","6","3.88"
"108537","13","13","12","1","10","3.88"
"108728","13","13","12","1","7","3.88"
"108734","16","16","16","0","13","3.88"
"108828","16","16","11","5","7","3.88"
"108840","13","13","13","0","8","3.88"
"109257","11","11","10","1","6","3.88"
"109324","11","11","10","1","5","3.88"
"109376","15","15","12","3","5","3.88"
"109759","10","10","9","1","5","3.88"
"109845","9","9","8","1","6","3.88"
"110027","9","9","7","2","6","3.88"
"110241","11","11","10","1","8","3.88"
"110430","12","12","12","0","8","3.88"
"110460","19","19","14","5","10","3.88"
"110788","17","17","16","1","11","3.88"
"110927","12","12","11","1","9","3.88"
"111380","13","13","11","2","6","3.88"
"111452","14","14","13","1","11","3.88"
"111826","16","16","15","1","10","3.88"
"112245","7","7","6","1","5","3.88"
"112374","11","11","9","2","7","3.88"
"112864","11","11","10","1","9","3.88"
"112885","11","11","10","1","6","3.88"
"113260","15","15","13","2","6","3.88"
"113660","15","15","13","2","11","3.88"
"113764","19","19","17","2","12","3.88"
"113799","13","13","12","1","7","3.88"
"114023","15","15","14","1","11","3.88"
"114394","11","11","11","0","7","3.88"
"114519","13","13","13","0","10","3.88"
"114596","16","16","12","4","10","3.88"
"114659","14","14","13","1","9","3.88"
"114865","17","17","15","2","10","3.88"
"114916","11","11","10","1","6","3.88"
"116653","17","17","16","1","11","3.88"
"116958","10","10","8","2","5","3.88"
"117004","8","8","8","0","8","3.88"
"117213","13","13","11","2","6","3.88"
"117369","21","21","18","3","11","3.88"
"117493","8","8","7","1","6","3.88"
"117599","20","20","16","4","10","3.88"
"100458","14","14","14","0","8","3.87"
"101961","13","13","12","1","7","3.87"
"103801","12","12","11","1","9","3.87"
"104880","16","16","14","2","12","3.87"
"106126","10","10","9","1","8","3.87"
"108672","16","16","14","2","7","3.87"
"109122","13","13","12","1","7","3.87"
"109309","14","14","13","1","7","3.87"
"109380","21","21","18","3","12","3.87"
"109978","20","20","19","1","16","3.87"
"111066","24","23","22","2","13","3.87"
"112663","17","17","15","2","9","3.87"
"112768","19","19","16","3","12","3.87"
"114312","17","17","16","1","14","3.87"
"114912","14","14","13","1","10","3.87"
"115960","12","12","12","0","9","3.87"
"116173","14","14","12","2","9","3.87"
"117051","13","13","13","0","8","3.87"
"117465","13","13","12","1","10","3.87"
"100402","12","12","10","2","9","3.86"
"100435","14","14","14","0","8","3.86"
"101105","11","11","11","0","9","3.86"
"101319","17","17","17","0","9","3.86"
"101362","14","14","12","2","8","3.86"
"101492","13","13","12","1","10","3.86"
"102619","10","10","10","0","9","3.86"
"102741","11","11","10","1","8","3.86"
"102743","22","22","17","5","11","3.86"
"103340","12","12","11","1","9","3.86"
"103902","12","12","11","1","10","3.86"
"104155","12","12","12","0","9","3.86"
"105858","16","16","16","0","11","3.86"
"105930","17","17","17","0","11","3.86"
"105964","21","21","18","3","13","3.86"
"106085","17","17","16","1","10","3.86"
"106148","16","16","13","3","9","3.86"
"106347","16","16","14","2","10","3.86"
"106760","19","19","15","4","7","3.86"
"106900","17","17","17","0","11","3.86"
"107048","12","12","11","1","10","3.86"
"107297","17","17","17","0","14","3.86"
"107312","12","12","10","2","7","3.86"
"107476","13","13","11","2","8","3.86"
"107919","20","20","19","1","12","3.86"
"108046","16","16","14","2","9","3.86"
"108135","9","9","9","0","8","3.86"
"108795","14","14","11","3","7","3.86"
"110714","9","9","9","0","7","3.86"
"111234","16","16","15","1","13","3.86"
"111285","18","18","16","2","8","3.86"
"111378","18","18","17","1","10","3.86"
"111531","11","11","11","0","7","3.86"
"111573","17","17","16","1","13","3.86"
"111595","15","15","15","0","9","3.86"
"111744","12","12","11","1","8","3.86"
"112589","14","14","13","1","8","3.86"
"112701","15","15","12","3","8","3.86"
"112984","9","9","9","0","7","3.86"
"113092","14","14","13","1","11","3.86"
"113502","13","13","13","0","8","3.86"
"113511","18","18","16","2","13","3.86"
"113837","16","16","15","1","12","3.86"
"114399","21","21","21","0","13","3.86"
"115021","12","12","11","1","9","3.86"
"115325","11","11","9","2","8","3.86"
"115381","10","10","9","1","7","3.86"
"115610","16","16","15","1","10","3.86"
"115692","13","13","9","4","7","3.86"
"115786","20","20","20","0","14","3.86"
"115800","15","15","15","0","9","3.86"
"116092","9","9","9","0","7","3.86"
"116353","8","8","8","0","8","3.86"
"116472","13","13","11","2","9","3.86"
"116544","13","13","10","3","9","3.86"
"116646","13","13","11","2","7","3.86"
"116828","11","11","10","1","8","3.86"
"117041","12","12","12","0","8","3.86"
"117073","15","15","9","6","9","3.86"
"117348","20","20","20","0","14","3.86"
"100266","19","19","17","2","10","3.85"
"100604","18","18","14","4","9","3.85"
"101096","13","13","11","2","9","3.85"
"102631","11","11","11","0","9","3.85"
"103372","20","20","18","2","13","3.85"
"105326","17","17","16","1","14","3.85"
"106013","13","13","12","1","9","3.85"
"107134","19","19","17","2","13","3.85"
"107406","17","17","16","1","15","3.85"
"107656","16","16","15","1","14","3.85"
"108250","14","14","13","1","12","3.85"
"111436","14","14","13","1","12","3.85"
"111973","16","16","16","0","9","3.85"
"111989","21","21","19","2","14","3.85"
"113672","17","17","17","0","12","3.85"
"115788","12","12","10","2","9","3.85"
"115836","16","16","16","0","12","3.85"
"116441","15","15","15","0","9","3.85"
"116453","19","19","17","2","12","3.85"
"117559","18","18","18","0","14","3.85"
"102347","20","20","18","2","14","3.84"
"105972","16","16","15","1","13","3.84"
"109599","20","20","18","2","12","3.84"
"100111","20","20","19","1","12","3.83"
"100132","12","12","12","0","7","3.83"
"100244","8","8","7","1","7","3.83"
"100395","9","9","9","0","8","3.83"
"100450","19","19","18","1","12","3.83"
"100475","16","16","15","1","11","3.83"
"100540","9","9","8","1","6","3.83"
"101414","9","9","7","2","6","3.83"
"101516","12","12","11","1","9","3.83"
"101583","11","11","11","0","9","3.83"
"101588","14","14","12","2","10","3.83"
"101627","13","13","12","1","8","3.83"
"101675","11","11","11","0","6","3.83"
"101922","17","17","15","2","10","3.83"
"101933","16","16","14","2","8","3.83"
"101950","12","12","10","2","7","3.83"
"102159","17","17","15","2","12","3.83"
"102206","10","10","7","3","6","3.83"
"102220","20","20","17","3","10","3.83"
"102230","13","13","13","0","9","3.83"
"102378","16","16","11","5","4","3.83"
"102403","15","15","12","3","10","3.83"
"103013","12","12","12","0","6","3.83"
"103047","16","16","14","2","8","3.83"
"103078","8","8","7","1","4","3.83"
"103081","13","13","10","3","8","3.83"
"103266","8","8","8","0","4","3.83"
"103364","16","16","12","4","7","3.83"
"103487","11","11","10","1","8","3.83"
"103529","15","15","11","4","6","3.83"
"103737","19","19","17","2","10","3.83"
"104114","13","13","12","1","9","3.83"
"104459","10","10","10","0","7","3.83"
"104604","10","10","8","2","6","3.83"
"104807","14","14","12","2","7","3.83"
"105146","11","11","10","1","6","3.83"
"105154","17","17","13","4","9","3.83"
"105181","15","15","15","0","10","3.83"
"105497","12","12","12","0","6","3.83"
"106327","10","10","10","0","6","3.83"
"106333","20","20","18","2","11","3.83"
"106476","11","11","11","0","10","3.83"
"106524","17","17","17","0","10","3.83"
"106537","16","16","14","2","12","3.83"
"106750","14","14","14","0","11","3.83"
"106839","10","10","9","1","7","3.83"
"106925","11","11","9","2","6","3.83"
"107009","10","10","8","2","5","3.83"
"107119","11","11","10","1","8","3.83"
"107256","12","12","10","2","6","3.83"
"107451","20","19","18","2","10","3.83"
"107494","10","10","9","1","6","3.83"
"107573","12","12","11","1","7","3.83"
"107585","14","14","13","1","7","3.83"
"107675","18","18","15","3","7","3.83"
"107862","10","10","8","2","5","3.83"
"108152","14","14","10","4","8","3.83"
"108188","9","9","8","1","6","3.83"
"108271","9","9","8","1","5","3.83"
"108317","11","11","10","1","4","3.83"
"108700","15","15","14","1","11","3.83"
"108716","13","13","11","2","8","3.83"
"109024","12","12","11","1","7","3.83"
"109447","12","12","12","0","8","3.83"
"109503","9","9","9","0","8","3.83"
"109746","11","11","8","3","4","3.83"
"109929","17","17","16","1","12","3.83"
"109951","13","13","10","3","7","3.83"
"110080","16","16","15","1","11","3.83"
"110082","15","15","13","2","10","3.83"
"110156","9","9","6","3","4","3.83"
"110201","21","21","18","3","13","3.83"
"110532","18","18","17","1","13","3.83"
"110776","13","13","12","1","10","3.83"
"110800","12","12","9","3","6","3.83"
"110818","22","22","22","0","14","3.83"
"110862","8","8","8","0","6","3.83"
"110996","11","11","10","1","5","3.83"
"111230","4","4","4","0","4","3.83"
"111407","11","11","10","1","6","3.83"
"111445","10","10","9","1","6","3.83"
"111501","15","15","12","3","11","3.83"
"111592","24","24","23","1","17","3.83"
"111711","17","17","15","2","10","3.83"
"111719","16","16","10","6","7","3.83"
"111796","12","12","10","2","4","3.83"
"112310","9","9","7","2","4","3.83"
"112493","13","13","12","1","6","3.83"
"112577","17","17","17","0","12","3.83"
"112787","18","18","16","2","11","3.83"
"113304","16","16","16","0","10","3.83"
"113399","13","13","11","2","10","3.83"
"113414","16","16","15","1","10","3.83"
"113519","17","17","15","2","9","3.83"
"113565","16","16","15","1","11","3.83"
"113740","13","13","10","3","9","3.83"
"113819","10","10","8","2","6","3.83"
"113828","6","6","5","1","4","3.83"
"113898","13","13","12","1","7","3.83"
"114005","14","14","14","0","9","3.83"
"114083","14","14","14","0","8","3.83"
"114141","12","12","10","2","4","3.83"
"114185","14","14","12","2","9","3.83"
"114343","7","7","7","0","6","3.83"
"114382","13","13","13","0","10","3.83"
"114572","10","10","9","1","6","3.83"
"114576","10","10","10","0","6","3.83"
"114604","15","15","13","2","10","3.83"
"114793","22","22","20","2","12","3.83"
"114888","14","14","13","1","5","3.83"
"114920","12","12","11","1","6","3.83"
"115105","18","18","16","2","12","3.83"
"115266","13","13","12","1","6","3.83"
"115288","11","11","9","2","6","3.83"
"115321","14","14","14","0","8","3.83"
"115636","17","17","16","1","12","3.83"
"115861","10","10","10","0","9","3.83"
"115933","14","14","12","2","7","3.83"
"116014","8","8","8","0","4","3.83"
"116091","17","17","15","2","10","3.83"
"116266","10","10","6","4","4","3.83"
"116434","12","12","12","0","7","3.83"
"116512","10","10","8","2","5","3.83"
"116630","19","19","18","1","9","3.83"
"116787","12","12","10","2","7","3.83"
"116794","19","19","19","0","11","3.83"
"116818","14","14","12","2","9","3.83"
"116981","10","10","10","0","6","3.83"
"117185","8","8","8","0","6","3.83"
"117258","10","10","10","0","7","3.83"
"117321","9","9","9","0","6","3.83"
"117412","11","11","11","0","8","3.83"
"100463","14","14","13","1","11","3.82"
"106590","19","19","17","2","12","3.82"
"109296","16","16","16","0","11","3.82"
"109941","15","15","14","1","12","3.82"
"113697","17","17","14","3","11","3.82"
"114952","17","17","17","0","12","3.82"
"100664","17","17","16","1","12","3.81"
"100758","15","15","14","1","13","3.81"
"101129","13","13","12","1","11","3.81"
"101237","17","17","15","2","11","3.81"
"101323","19","19","16","3","14","3.81"
"101383","13","13","11","2","9","3.81"
"101874","14","14","14","0","10","3.81"
"102125","15","15","12","3","7","3.81"
"103443","20","20","19","1","13","3.81"
"103937","18","18","17","1","9","3.81"
"104143","17","17","14","3","8","3.81"
"104327","16","16","14","2","12","3.81"
"104615","18","18","17","1","11","3.81"
"105305","11","11","11","0","9","3.81"
"105426","12","12","11","1","9","3.81"
"105464","19","19","16","3","10","3.81"
"105790","19","19","18","1","11","3.81"
"106040","11","11","11","0","9","3.81"
"106549","13","13","12","1","8","3.81"
"106629","15","14","14","1","9","3.81"
"106639","17","17","16","1","11","3.81"
"107108","15","15","14","1","9","3.81"
"107302","14","14","12","2","12","3.81"
"108031","15","15","14","1","9","3.81"
"108895","9","9","9","0","8","3.81"
"109025","14","14","14","0","9","3.81"
"109508","17","17","17","0","12","3.81"
"109900","19","19","16","3","11","3.81"
"110029","15","15","15","0","11","3.81"
"110212","15","15","11","4","9","3.81"
"110624","17","17","15","2","13","3.81"
"110758","13","13","13","0","10","3.81"
"110825","16","16","15","1","12","3.81"
"110945","16","16","15","1","14","3.81"
"110977","19","19","16","3","13","3.81"
"111007","24","24","23","1","15","3.81"
"111343","12","12","12","0","10","3.81"
"111395","13","13","11","2","10","3.81"
"112062","15","15","14","1","10","3.81"
"112445","17","17","12","5","10","3.81"
"113953","25","25","24","1","21","3.81"
"114531","17","17","17","0","12","3.81"
"114775","18","18","16","2","12","3.81"
"115134","13","13","11","2","9","3.81"
"115814","17","17","15","2","11","3.81"
"116139","14","14","14","0","10","3.81"
"116412","12","12","12","0","7","3.81"
"117177","18","17","17","1","11","3.81"
"117244","11","11","9","2","9","3.81"
"117354","18","18","17","1","10","3.81"
"100069","17","17","16","1","9","3.80"
"100222","18","18","15","3","8","3.80"
"100270","13","13","12","1","10","3.80"
"100507","6","6","5","1","5","3.80"
"100740","11","11","9","2","5","3.80"
"100960","14","14","13","1","8","3.80"
"101020","12","12","12","0","6","3.80"
"101140","12","12","10","2","6","3.80"
"101255","8","8","8","0","6","3.80"
"101268","11","11","11","0","7","3.80"
"101325","10","10","8","2","7","3.80"
"101385","15","15","14","1","7","3.80"
"101472","12","12","12","0","10","3.80"
"101949","13","13","13","0","6","3.80"
"102099","9","9","9","0","6","3.80"
"102146","15","15","11","4","7","3.80"
"102528","17","17","16","1","11","3.80"
"102678","15","15","12","3","6","3.80"
"102754","15","15","15","0","13","3.80"
"102868","17","17","15","2","8","3.80"
"102924","9","9","8","1","5","3.80"
"103063","15","15","14","1","12","3.80"
"103317","12","12","9","3","8","3.80"
"103415","7","7","6","1","5","3.80"
"103470","7","7","6","1","5","3.80"
"103525","12","12","11","1","6","3.80"
"103602","10","10","8","2","5","3.80"
"103821","12","12","12","0","9","3.80"
"104087","12","11","12","0","8","3.80"
"104126","13","13","12","1","6","3.80"
"104295","14","14","12","2","7","3.80"
"104827","16","16","13","3","8","3.80"
"104929","8","8","6","2","5","3.80"
"105003","11","11","11","0","8","3.80"
"105046","13","13","12","1","8","3.80"
"105608","12","12","10","2","6","3.80"
"105666","12","12","9","3","6","3.80"
"105711","14","14","13","1","8","3.80"
"105882","10","10","9","1","5","3.80"
"105942","21","21","18","3","8","3.80"
"106140","14","14","13","1","7","3.80"
"106516","8","8","8","0","6","3.80"
"106600","18","18","18","0","14","3.80"
"106720","13","13","12","1","7","3.80"
"106767","14","14","10","4","9","3.80"
"106929","11","11","9","2","5","3.80"
"106964","16","16","15","1","8","3.80"
"107114","15","15","14","1","6","3.80"
"107240","14","14","14","0","12","3.80"
"107287","13","13","11","2","7","3.80"
"107562","14","14","13","1","8","3.80"
"107641","12","12","10","2","6","3.80"
"107702","11","11","11","0","8","3.80"
"107955","19","19","12","7","11","3.80"
"108273","15","15","13","2","7","3.80"
"108370","16","16","15","1","7","3.80"
"108584","15","15","13","2","8","3.80"
"108780","11","11","10","1","6","3.80"
"108803","14","14","11","3","9","3.80"
"109141","13","13","13","0","7","3.80"
"109898","11","11","10","1","6","3.80"
"109966","7","7","7","0","5","3.80"
"109974","12","12","12","0","7","3.80"
"110186","11","11","10","1","7","3.80"
"110452","11","11","10","1","5","3.80"
"110768","17","17","16","1","8","3.80"
"110830","7","7","6","1","5","3.80"
"110999","12","12","11","1","8","3.80"
"111208","19","19","18","1","11","3.80"
"111678","8","8","7","1","5","3.80"
"111737","18","18","17","1","9","3.80"
"111914","10","10","9","1","8","3.80"
"112154","11","11","10","1","5","3.80"
"112312","10","10","10","0","6","3.80"
"112443","10","10","9","1","7","3.80"
"112465","19","19","18","1","15","3.80"
"112505","12","12","12","0","6","3.80"
"112526","16","16","13","3","6","3.80"
"112950","13","13","13","0","6","3.80"
"113067","9","9","9","0","7","3.80"
"113090","12","12","11","1","8","3.80"
"113268","15","15","14","1","7","3.80"
"113383","11","11","11","0","6","3.80"
"113600","12","12","10","2","7","3.80"
"113802","18","18","13","5","10","3.80"
"113839","11","11","7","4","6","3.80"
"113910","14","14","14","0","5","3.80"
"113954","17","17","15","2","7","3.80"
"114090","14","14","12","2","6","3.80"
"114598","11","11","9","2","7","3.80"
"114740","11","11","11","0","6","3.80"
"114779","13","13","11","2","7","3.80"
"114934","11","11","9","2","5","3.80"
"115061","12","12","11","1","7","3.80"
"115335","10","10","8","2","6","3.80"
"115443","14","14","13","1","6","3.80"
"115733","12","12","11","1","7","3.80"
"115932","10","10","9","1","6","3.80"
"115959","12","12","11","1","5","3.80"
"116012","12","12","12","0","7","3.80"
"116194","9","9","7","2","5","3.80"
"116257","13","13","12","1","5","3.80"
"116450","16","16","12","4","11","3.80"
"116470","12","12","11","1","9","3.80"
"116508","15","15","15","0","10","3.80"
"116554","16","16","15","1","11","3.80"
"116655","13","13","11","2","6","3.80"
"116784","14","14","12","2","7","3.80"
"116812","8","8","6","2","5","3.80"
"117494","13","13","12","1","7","3.80"
"117551","10","10","9","1","8","3.80"
"100263","20","20","18","2","9","3.79"
"100703","17","17","16","1","10","3.79"
"100955","19","19","18","1","12","3.79"
"101667","11","11","11","0","9","3.79"
"102090","17","17","16","1","9","3.79"
"102237","12","12","12","0","8","3.79"
"103230","15","15","15","0","12","3.79"
"103582","17","17","16","1","10","3.79"
"103881","15","15","13","2","8","3.79"
"103961","17","17","17","0","12","3.79"
"103968","19","19","15","4","11","3.79"
"104161","14","14","13","1","11","3.79"
"104484","16","16","16","0","9","3.79"
"104618","18","18","14","4","10","3.79"
"104638","17","17","16","1","13","3.79"
"104816","14","14","13","1","9","3.79"
"105768","12","12","12","0","10","3.79"
"106506","22","22","19","3","13","3.79"
"107228","12","12","11","1","9","3.79"
"107268","14","14","14","0","9","3.79"
"108276","12","12","12","0","9","3.79"
"108681","14","14","13","1","11","3.79"
"109390","18","18","17","1","9","3.79"
"109396","13","13","12","1","10","3.79"
"109614","13","13","11","2","10","3.79"
"109616","18","18","17","1","10","3.79"
"109725","15","15","13","2","11","3.79"
"109980","25","25","22","3","13","3.79"
"109994","14","14","14","0","9","3.79"
"110894","15","15","14","1","11","3.79"
"110995","16","16","14","2","10","3.79"
"111265","12","12","12","0","10","3.79"
"111301","10","10","9","1","7","3.79"
"113617","12","12","12","0","8","3.79"
"113803","14","14","12","2","10","3.79"
"113836","9","9","8","1","8","3.79"
"114152","14","14","13","1","11","3.79"
"114573","13","13","13","0","8","3.79"
"114652","14","14","13","1","10","3.79"
"114799","12","12","9","3","8","3.79"
"114806","12","12","12","0","10","3.79"
"114818","16","16","14","2","10","3.79"
"115030","14","14","14","0","10","3.79"
"115036","14","14","13","1","9","3.79"
"115045","13","13","9","4","9","3.79"
"115093","11","11","10","1","9","3.79"
"115546","16","16","13","3","11","3.79"
"115685","18","18","17","1","13","3.79"
"115908","15","15","13","2","10","3.79"
"116193","12","12","12","0","9","3.79"
"116739","19","19","15","4","10","3.79"
"116806","17","17","16","1","12","3.79"
"117350","16","16","16","0","9","3.79"
"101408","13","13","12","1","9","3.78"
"102243","22","22","21","1","14","3.78"
"103090","16","16","14","2","9","3.78"
"103178","11","11","11","0","10","3.78"
"103293","22","22","20","2","11","3.78"
"104745","15","15","14","1","11","3.78"
"104844","17","17","16","1","10","3.78"
"105040","13","13","11","2","9","3.78"
"105591","11","11","11","0","8","3.78"
"106520","7","7","6","1","5","3.78"
"106670","18","18","17","1","14","3.78"
"106968","14","14","12","2","11","3.78"
"107580","10","10","9","1","5","3.78"
"107759","13","13","12","1","5","3.78"
"109425","20","20","18","2","15","3.78"
"109788","14","14","11","3","9","3.78"
"110024","22","22","19","3","10","3.78"
"110091","20","20","19","1","17","3.78"
"111468","10","10","8","2","5","3.78"
"112560","12","12","12","0","8","3.78"
"112605","9","9","9","0","6","3.78"
"113255","12","12","10","2","5","3.78"
"113578","18","18","16","2","13","3.78"
"114058","14","14","13","1","9","3.78"
"114064","19","19","18","1","14","3.78"
"114126","18","18","18","0","11","3.78"
"115309","14","14","12","2","8","3.78"
"115622","19","19","19","0","14","3.78"
"115879","21","21","19","2","14","3.78"
"116189","5","5","5","0","5","3.78"
"116371","19","19","18","1","12","3.78"
"116612","19","19","17","2","12","3.78"
"116624","9","9","9","0","7","3.78"
"116692","12","12","12","0","6","3.78"
"117462","16","16","15","1","9","3.78"
"117516","21","21","20","1","11","3.78"
"100142","13","13","12","1","11","3.77"
"103053","15","15","14","1","9","3.77"
"103095","14","14","13","1","11","3.77"
"103693","14","14","12","2","10","3.77"
"105982","17","17","14","3","9","3.77"
"107361","11","11","9","2","8","3.77"
"107942","17","17","16","1","10","3.77"
"108255","14","14","12","2","11","3.77"
"109430","20","20","19","1","13","3.77"
"110503","19","19","19","0","12","3.77"
"110730","11","11","9","2","8","3.77"
"110809","12","12","12","0","9","3.77"
"111433","24","24","23","1","18","3.77"
"111944","13","13","10","3","8","3.77"
"113284","19","19","16","3","11","3.77"
"113919","15","15","12","3","10","3.77"
"114567","14","14","14","0","11","3.77"
"114852","24","24","21","3","15","3.77"
"115782","18","18","16","2","14","3.77"
"116632","13","13","11","2","11","3.77"
"100179","14","14","13","1","10","3.76"
"100456","14","14","12","2","12","3.76"
"101574","24","24","20","4","14","3.76"
"102189","21","21","21","0","16","3.76"
"103676","20","20","19","1","16","3.76"
"104083","15","15","14","1","11","3.76"
"107801","14","14","11","3","10","3.76"
"108168","17","17","17","0","13","3.76"
"108479","15","15","14","1","12","3.76"
"109367","14","14","14","0","11","3.76"
"109720","12","12","11","1","11","3.76"
"110242","13","13","13","0","11","3.76"
"114536","17","17","15","2","13","3.76"
"115115","16","16","16","0","10","3.76"
"115630","15","15","14","1","12","3.76"
"117563","15","15","14","1","13","3.76"
"117614","16","16","14","2","10","3.76"
"100003","9","9","7","2","4","3.75"
"100065","12","12","8","4","5","3.75"
"100102","9","9","7","2","7","3.75"
"100221","5","5","5","0","4","3.75"
"100257","15","15","14","1","10","3.75"
"100305","16","16","12","4","6","3.75"
"100524","16","16","15","1","9","3.75"
"100679","8","8","8","0","6","3.75"
"100692","11","11","9","2","6","3.75"
"100718","6","6","6","0","4","3.75"
"100729","16","16","13","3","10","3.75"
"100762","10","10","8","2","4","3.75"
"100774","16","16","13","3","8","3.75"
"100909","14","14","10","4","6","3.75"
"101007","11","11","10","1","7","3.75"
"101234","3","3","3","0","3","3.75"
"101339","12","12","9","3","8","3.75"
"101436","8","8","7","1","6","3.75"
"101466","14","14","11","3","10","3.75"
"101474","7","7","6","1","5","3.75"
"101573","10","10","8","2","6","3.75"
"101591","18","18","16","2","11","3.75"
"101618","18","18","17","1","13","3.75"
"101647","12","12","10","2","7","3.75"
"101738","8","8","7","1","5","3.75"
"101767","9","9","9","0","5","3.75"
"101902","10","10","10","0","8","3.75"
"102035","5","5","4","1","3","3.75"
"102053","22","22","22","0","16","3.75"
"102152","12","12","11","1","5","3.75"
"102313","9","9","9","0","4","3.75"
"102337","12","12","12","0","7","3.75"
"102380","12","12","11","1","5","3.75"
"102419","9","9","9","0","6","3.75"
"102431","14","14","10","4","4","3.75"
"102575","16","16","16","0","11","3.75"
"102595","12","12","11","1","5","3.75"
"102648","12","12","10","2","7","3.75"
"102673","10","10","10","0","10","3.75"
"102679","11","11","10","1","5","3.75"
"102697","12","12","10","2","7","3.75"
"102701","13","13","12","1","6","3.75"
"102730","12","12","10","2","9","3.75"
"102761","9","9","8","1","4","3.75"
"102763","18","18","16","2","9","3.75"
"102860","13","13","13","0","8","3.75"
"102896","9","9","8","1","4","3.75"
"102937","18","18","17","1","10","3.75"
"103076","11","11","11","0","4","3.75"
"103160","18","18","17","1","9","3.75"
"103183","9","9","9","0","6","3.75"
"103507","11","11","10","1","8","3.75"
"103526","20","20","15","5","10","3.75"
"103649","10","10","8","2","6","3.75"
"103846","11","11","10","1","4","3.75"
"103850","18","18","17","1","9","3.75"
"104092","10","10","9","1","5","3.75"
"104318","14","14","12","2","9","3.75"
"104320","8","8","8","0","4","3.75"
"104442","17","17","15","2","14","3.75"
"104455","11","11","10","1","7","3.75"
"104518","14","14","11","3","8","3.75"
"104534","17","17","15","2","10","3.75"
"104558","14","14","13","1","8","3.75"
"104600","13","13","13","0","9","3.75"
"104609","4","4","4","0","3","3.75"
"104724","12","12","12","0","7","3.75"
"104825","12","12","12","0","4","3.75"
"104889","9","9","8","1","3","3.75"
"104891","13","13","11","2","7","3.75"
"104937","20","20","17","3","14","3.75"
"105014","13","13","12","1","10","3.75"
"105075","12","11","11","1","4","3.75"
"105076","8","8","6","2","4","3.75"
"105120","16","16","13","3","8","3.75"
"105123","8","8","7","1","4","3.75"
"105138","11","11","11","0","7","3.75"
"105204","15","15","13","2","9","3.75"
"105209","14","14","13","1","6","3.75"
"105223","20","20","18","2","15","3.75"
"105299","17","17","15","2","8","3.75"
"105376","17","17","13","4","9","3.75"
"105390","11","11","9","2","8","3.75"
"105505","11","11","9","2","8","3.75"
"105528","15","15","13","2","7","3.75"
"105655","9","9","7","2","4","3.75"
"105681","13","13","9","4","6","3.75"
"105726","11","11","10","1","7","3.75"
"105782","9","9","9","0","6","3.75"
"105906","10","10","9","1","6","3.75"
"105936","11","11","10","1","6","3.75"
"106094","14","14","13","1","11","3.75"
"106111","6","6","6","0","6","3.75"
"106131","16","16","14","2","8","3.75"
"106239","10","10","9","1","4","3.75"
"106326","12","12","11","1","7","3.75"
"106404","13","13","12","1","6","3.75"
"106456","15","15","14","1","9","3.75"
"106502","10","10","8","2","4","3.75"
"106602","17","17","16","1","13","3.75"
"106632","14","14","12","2","12","3.75"
"106685","11","11","11","0","6","3.75"
"106956","9","9","8","1","6","3.75"
"106980","9","9","6","3","5","3.75"
"107016","14","14","9","5","8","3.75"
"107087","20","20","19","1","8","3.75"
"107146","15","15","14","1","9","3.75"
"107382","16","16","15","1","8","3.75"
"107409","15","15","14","1","10","3.75"
"107622","9","9","7","2","5","3.75"
"107763","14","14","13","1","10","3.75"
"107860","10","10","8","2","6","3.75"
"108056","12","12","11","1","5","3.75"
"108141","10","10","9","1","4","3.75"
"108223","10","10","9","1","5","3.75"
"108454","24","24","22","2","15","3.75"
"108460","10","10","9","1","5","3.75"
"108471","15","15","11","4","8","3.75"
"108473","9","9","8","1","7","3.75"
"108527","16","16","15","1","8","3.75"
"108622","11","11","10","1","7","3.75"
"108643","11","11","9","2","5","3.75"
"108736","7","7","6","1","5","3.75"
"108807","15","15","14","1","7","3.75"
"108841","7","7","6","1","6","3.75"
"108970","14","14","11","3","8","3.75"
"108971","15","15","14","1","12","3.75"
"108977","15","15","15","0","12","3.75"
"109070","5","5","5","0","3","3.75"
"109088","15","15","14","1","11","3.75"
"109289","7","7","6","1","3","3.75"
"109292","16","16","14","2","8","3.75"
"109341","13","13","12","1","7","3.75"
"109424","11","11","10","1","7","3.75"
"109475","6","6","6","0","4","3.75"
"109536","13","13","11","2","5","3.75"
"109633","9","9","9","0","7","3.75"
"109684","17","17","15","2","14","3.75"
"109777","10","10","7","3","4","3.75"
"109784","10","10","10","0","4","3.75"
"109855","6","6","6","0","4","3.75"
"109867","17","17","14","3","7","3.75"
"109914","14","14","14","0","8","3.75"
"109919","16","16","11","5","5","3.75"
"110103","13","13","12","1","9","3.75"
"110184","16","16","15","1","10","3.75"
"110349","11","11","11","0","7","3.75"
"110384","9","9","9","0","6","3.75"
"110385","12","12","12","0","9","3.75"
"110554","14","14","12","2","7","3.75"
"110567","13","13","10","3","5","3.75"
"110653","11","11","11","0","7","3.75"
"110716","12","12","9","3","3","3.75"
"110774","14","14","12","2","9","3.75"
"110787","10","10","6","4","4","3.75"
"110952","14","14","12","2","9","3.75"
"111282","6","6","5","1","4","3.75"
"111406","17","17","16","1","11","3.75"
"111569","13","13","13","0","10","3.75"
"111675","24","24","22","2","16","3.75"
"111680","19","19","18","1","13","3.75"
"111745","5","5","5","0","4","3.75"
"111865","16","16","14","2","8","3.75"
"111889","7","7","6","1","6","3.75"
"111925","8","8","7","1","4","3.75"
"111945","21","21","17","4","9","3.75"
"111991","15","15","15","0","11","3.75"
"112057","4","4","4","0","4","3.75"
"112078","11","11","8","3","4","3.75"
"112087","7","7","7","0","6","3.75"
"112102","11","11","10","1","7","3.75"
"112167","14","14","13","1","7","3.75"
"112248","13","13","13","0","8","3.75"
"112305","11","11","9","2","7","3.75"
"112402","16","16","14","2","10","3.75"
"112527","13","12","12","1","7","3.75"
"112678","17","17","16","1","11","3.75"
"112766","6","6","6","0","4","3.75"
"112913","7","7","7","0","5","3.75"
"112933","12","12","8","4","7","3.75"
"112951","16","16","16","0","12","3.75"
"112974","3","3","3","0","3","3.75"
"113263","11","11","8","3","4","3.75"
"113291","12","12","9","3","8","3.75"
"113339","14","14","10","4","5","3.75"
"113418","13","13","11","2","7","3.75"
"113495","9","9","8","1","4","3.75"
"113569","7","7","5","2","3","3.75"
"113736","16","16","13","3","5","3.75"
"113831","7","7","7","0","6","3.75"
"113918","12","12","9","3","7","3.75"
"114021","9","9","7","2","4","3.75"
"114212","12","12","10","2","4","3.75"
"114234","16","16","14","2","9","3.75"
"114288","14","14","11","3","8","3.75"
"114295","14","14","13","1","10","3.75"
"114380","9","9","9","0","6","3.75"
"114386","15","15","14","1","9","3.75"
"114455","11","11","9","2","6","3.75"
"114468","11","11","10","1","7","3.75"
"114746","14","14","11","3","8","3.75"
"114766","12","12","12","0","8","3.75"
"114772","10","10","10","0","8","3.75"
"114979","8","8","8","0","5","3.75"
"115000","17","16","14","3","6","3.75"
"115235","6","6","6","0","4","3.75"
"115399","13","13","12","1","8","3.75"
"115522","8","8","7","1","4","3.75"
"115529","16","16","15","1","10","3.75"
"115560","17","16","14","3","9","3.75"
"115663","13","13","11","2","7","3.75"
"115734","13","13","11","2","10","3.75"
"115758","15","15","14","1","11","3.75"
"116051","12","12","12","0","7","3.75"
"116147","10","10","9","1","4","3.75"
"116201","10","10","10","0","6","3.75"
"116313","10","10","8","2","6","3.75"
"116430","11","11","11","0","8","3.75"
"116527","14","14","14","0","11","3.75"
"116615","15","15","14","1","11","3.75"
"116678","14","14","12","2","10","3.75"
"116724","11","11","10","1","8","3.75"
"116742","15","15","12","3","11","3.75"
"116745","9","9","7","2","6","3.75"
"116941","7","7","7","0","3","3.75"
"116957","8","8","7","1","4","3.75"
"116995","11","11","11","0","10","3.75"
"116998","23","23","22","1","16","3.75"
"117002","11","11","9","2","5","3.75"
"117032","12","12","10","2","7","3.75"
"117060","17","17","13","4","7","3.75"
"117157","10","10","10","0","5","3.75"
"117199","17","17","16","1","8","3.75"
"117217","10","10","10","0","7","3.75"
"117227","11","11","11","0","8","3.75"
"117589","13","13","10","3","9","3.75"
"105213","17","17","14","3","10","3.74"
"106355","22","22","19","3","13","3.74"
"108997","18","18","15","3","11","3.74"
"109977","16","16","14","2","11","3.74"
"110902","15","14","15","0","12","3.74"
"111427","15","15","13","2","10","3.74"
"112223","18","18","17","1","13","3.74"
"112265","17","17","16","1","12","3.74"
"113768","18","18","17","1","11","3.74"
"114448","16","16","16","0","11","3.74"
"114475","16","16","14","2","11","3.74"
"114674","14","14","14","0","10","3.74"
"114833","19","19","19","0","16","3.74"
"117602","24","24","20","4","13","3.74"
"100015","11","11","11","0","7","3.73"
"100883","16","16","15","1","10","3.73"
"101217","17","17","16","1","12","3.73"
"101725","20","20","19","1","16","3.73"
"101978","14","14","14","0","13","3.73"
"103278","20","20","19","1","13","3.73"
"103431","23","23","22","1","13","3.73"
"103545","14","14","12","2","9","3.73"
"104002","16","16","13","3","10","3.73"
"104371","17","17","16","1","12","3.73"
"104431","18","18","15","3","12","3.73"
"105389","11","11","11","0","8","3.73"
"106382","19","19","16","3","13","3.73"
"106650","13","13","13","0","10","3.73"
"106864","22","22","17","5","11","3.73"
"107097","13","13","12","1","10","3.73"
"107324","14","14","13","1","12","3.73"
"107665","17","17","16","1","15","3.73"
"108655","14","14","13","1","8","3.73"
"109611","16","16","15","1","9","3.73"
"110326","13","13","10","3","9","3.73"
"110599","14","14","13","1","11","3.73"
"111198","14","14","12","2","8","3.73"
"111490","13","13","13","0","7","3.73"
"112585","17","17","15","2","11","3.73"
"113057","16","16","16","0","13","3.73"
"114077","21","21","16","5","10","3.73"
"114738","15","15","15","0","9","3.73"
"115540","20","20","20","0","14","3.73"
"116460","22","22","20","2","16","3.73"
"100140","11","11","9","2","8","3.72"
"100292","13","13","13","0","8","3.72"
"100986","17","17","17","0","12","3.72"
"102109","16","16","15","1","12","3.72"
"102113","20","20","18","2","11","3.72"
"102410","15","15","14","1","11","3.72"
"102723","19","19","16","3","12","3.72"
"102866","23","23","21","2","13","3.72"
"102939","22","22","20","2","15","3.72"
"103359","17","17","16","1","13","3.72"
"103673","24","24","24","0","18","3.72"
"104165","15","15","14","1","13","3.72"
"104531","21","21","18","3","11","3.72"
"104703","15","15","13","2","11","3.72"
"105607","22","22","22","0","16","3.72"
"105707","20","20","19","1","13","3.72"
"106132","18","18","15","3","12","3.72"
"107943","19","19","17","2","11","3.72"
"108236","14","14","12","2","9","3.72"
"108385","21","21","20","1","17","3.72"
"110505","19","19","16","3","11","3.72"
"111010","13","13","13","0","10","3.72"
"111661","19","19","18","1","14","3.72"
"111769","13","13","13","0","11","3.72"
"112330","12","12","11","1","8","3.72"
"112716","13","13","11","2","9","3.72"
"113200","19","19","18","1","9","3.72"
"113404","16","16","14","2","14","3.72"
"113465","18","18","16","2","11","3.72"
"113636","19","19","19","0","10","3.72"
"113859","19","19","18","1","13","3.72"
"114073","15","15","14","1","11","3.72"
"114115","12","12","12","0","9","3.72"
"114914","16","16","15","1","10","3.72"
"115161","13","13","12","1","9","3.72"
"115313","19","19","18","1","11","3.72"
"115901","16","16","12","4","6","3.72"
"116085","17","17","16","1","12","3.72"
"116953","21","21","19","2","15","3.72"
"117337","15","15","14","1","13","3.72"
"117389","13","13","13","0","9","3.72"
"100184","12","12","11","1","9","3.71"
"100308","14","14","14","0","10","3.71"
"100638","11","11","9","2","7","3.71"
"100918","17","17","14","3","11","3.71"
"101053","12","12","12","0","9","3.71"
"101374","14","14","13","1","8","3.71"
"101590","16","16","14","2","10","3.71"
"101631","21","21","21","0","11","3.71"
"101777","18","18","17","1","14","3.71"
"101800","16","16","16","0","12","3.71"
"101801","17","17","17","0","16","3.71"
"101819","16","16","15","1","12","3.71"
"102074","18","18","16","2","13","3.71"
"102628","12","12","11","1","7","3.71"
"102969","14","14","14","0","10","3.71"
"103179","18","18","18","0","12","3.71"
"103189","18","18","17","1","10","3.71"
"103500","16","16","15","1","9","3.71"
"103579","11","11","10","1","8","3.71"
"103653","11","11","11","0","7","3.71"
"103662","18","18","15","3","11","3.71"
"103863","20","20","18","2","13","3.71"
"104029","13","13","13","0","10","3.71"
"104034","17","17","14","3","12","3.71"
"104252","10","10","10","0","7","3.71"
"104403","11","11","8","3","7","3.71"
"104511","10","10","7","3","7","3.71"
"104521","19","19","18","1","13","3.71"
"104570","12","12","11","1","10","3.71"
"104661","13","13","11","2","9","3.71"
"104747","17","17","14","3","11","3.71"
"105888","16","16","15","1","12","3.71"
"105974","11","11","11","0","7","3.71"
"106027","18","18","15","3","11","3.71"
"106323","10","10","10","0","8","3.71"
"107363","11","11","9","2","8","3.71"
"107991","14","14","10","4","9","3.71"
"108140","13","13","12","1","11","3.71"
"108198","10","10","10","0","8","3.71"
"108308","17","17","14","3","11","3.71"
"108545","12","12","12","0","7","3.71"
"108656","18","18","16","2","11","3.71"
"108879","11","11","11","0","10","3.71"
"108919","22","22","22","0","19","3.71"
"109444","11","11","10","1","9","3.71"
"109465","11","11","11","0","9","3.71"
"109897","13","13","12","1","9","3.71"
"110094","20","20","19","1","13","3.71"
"110133","14","14","14","0","8","3.71"
"110574","14","14","14","0","10","3.71"
"110629","19","19","18","1","16","3.71"
"110792","16","16","15","1","11","3.71"
"110813","12","12","12","0","9","3.71"
"110891","11","11","11","0","9","3.71"
"110916","13","13","12","1","9","3.71"
"111478","8","8","7","1","7","3.71"
"111849","14","14","12","2","8","3.71"
"111930","8","8","8","0","7","3.71"
"112512","15","15","12","3","9","3.71"
"112514","12","12","11","1","9","3.71"
"112852","16","16","15","1","11","3.71"
"112862","19","19","16","3","9","3.71"
"112975","15","15","11","4","7","3.71"
"113322","13","13","13","0","9","3.71"
"113515","17","17","16","1","8","3.71"
"113966","14","14","13","1","10","3.71"
"114503","11","11","11","0","8","3.71"
"114679","11","11","9","2","7","3.71"
"114691","25","25","21","4","15","3.71"
"114909","16","16","15","1","11","3.71"
"115087","15","15","15","0","11","3.71"
"115119","11","11","10","1","9","3.71"
"115262","15","15","14","1","11","3.71"
"115274","17","17","16","1","11","3.71"
"115319","16","16","13","3","7","3.71"
"115374","20","20","19","1","10","3.71"
"115472","15","15","13","2","13","3.71"
"115728","24","24","22","2","13","3.71"
"115855","10","10","9","1","7","3.71"
"115877","15","15","15","0","8","3.71"
"115995","16","16","16","0","13","3.71"
"116056","10","10","10","0","9","3.71"
"116080","13","13","12","1","11","3.71"
"116226","12","12","12","0","7","3.71"
"116314","16","16","16","0","12","3.71"
"116563","13","13","12","1","10","3.71"
"116579","15","15","14","1","11","3.71"
"116717","15","15","14","1","11","3.71"
"116937","20","20","20","0","14","3.71"
"116966","10","10","10","0","8","3.71"
"117038","14","14","12","2","9","3.71"
"117086","18","18","16","2","11","3.71"
"117261","12","12","12","0","10","3.71"
"117546","18","18","18","0","15","3.71"
"100017","14","14","11","3","6","3.70"
"100028","16","16","14","2","9","3.70"
"100258","11","11","11","0","10","3.70"
"100379","15","15","13","2","6","3.70"
"100566","7","7","7","0","6","3.70"
"101137","11","11","8","3","6","3.70"
"101299","14","14","14","0","8","3.70"
"101308","16","16","15","1","9","3.70"
"101876","12","12","11","1","8","3.70"
"102561","10","10","8","2","6","3.70"
"102566","9","9","9","0","8","3.70"
"102613","10","10","9","1","6","3.70"
"102849","10","10","10","0","9","3.70"
"103016","10","10","9","1","6","3.70"
"103119","15","15","14","1","13","3.70"
"103205","15","15","11","4","8","3.70"
"103514","15","15","15","0","9","3.70"
"103575","9","9","9","0","6","3.70"
"103667","9","9","8","1","8","3.70"
"103983","11","11","10","1","9","3.70"
"104183","11","11","11","0","7","3.70"
"104225","11","11","11","0","8","3.70"
"104343","19","19","19","0","14","3.70"
"104351","13","13","13","0","10","3.70"
"104388","12","12","10","2","7","3.70"
"104966","13","13","12","1","8","3.70"
"104975","14","14","14","0","12","3.70"
"105126","23","23","21","2","14","3.70"
"105163","12","12","11","1","7","3.70"
"105165","13","13","10","3","8","3.70"
"105465","9","9","8","1","6","3.70"
"105718","13","13","12","1","9","3.70"
"105954","18","18","18","0","14","3.70"
"106492","8","8","7","1","6","3.70"
"106946","9","9","8","1","6","3.70"
"107346","11","11","10","1","7","3.70"
"107636","12","12","9","3","7","3.70"
"107754","18","18","15","3","7","3.70"
"107819","13","13","12","1","8","3.70"
"108162","10","9","10","0","9","3.70"
"108922","12","12","11","1","6","3.70"
"108927","11","11","8","3","6","3.70"
"109009","12","12","12","0","6","3.70"
"109040","11","11","11","0","6","3.70"
"109255","10","10","8","2","6","3.70"
"109433","17","17","15","2","9","3.70"
"109442","16","16","15","1","9","3.70"
"109674","14","14","10","4","6","3.70"
"109912","12","12","12","0","10","3.70"
"110006","12","12","11","1","9","3.70"
"110168","17","17","14","3","8","3.70"
"110633","14","14","12","2","8","3.70"
"110936","11","11","9","2","7","3.70"
"111011","10","10","7","3","6","3.70"
"111252","17","17","14","3","10","3.70"
"111278","13","13","12","1","7","3.70"
"111775","12","12","10","2","6","3.70"
"111863","11","11","10","1","8","3.70"
"111952","11","11","9","2","6","3.70"
"112394","11","11","9","2","7","3.70"
"112596","12","12","11","1","8","3.70"
"112955","12","12","11","1","8","3.70"
"113267","16","16","15","1","10","3.70"
"113425","10","10","8","2","7","3.70"
"113564","12","12","12","0","6","3.70"
"113588","13","13","11","2","9","3.70"
"114034","17","17","16","1","10","3.70"
"114203","11","11","10","1","6","3.70"
"114591","10","10","9","1","7","3.70"
"114769","15","15","13","2","8","3.70"
"114805","15","15","13","2","7","3.70"
"114931","14","14","13","1","8","3.70"
"115312","9","9","8","1","7","3.70"
"115359","14","14","11","3","8","3.70"
"115376","15","15","15","0","7","3.70"
"115482","9","9","8","1","6","3.70"
"115562","18","18","13","5","7","3.70"
"115909","12","12","10","2","6","3.70"
"116178","13","13","13","0","12","3.70"
"116259","12","12","10","2","7","3.70"
"116438","16","16","12","4","7","3.70"
"116533","8","8","7","1","6","3.70"
"116672","12","12","10","2","9","3.70"
"117057","12","12","11","1","9","3.70"
"117343","8","8","7","1","7","3.70"
"117371","17","17","17","0","13","3.70"
"117523","15","15","13","2","11","3.70"
"100213","16","16","16","0","11","3.69"
"100541","20","20","20","0","14","3.69"
"101035","13","13","13","0","9","3.69"
"101210","15","15","15","0","10","3.69"
"101215","19","19","16","3","14","3.69"
"101267","18","18","16","2","10","3.69"
"101495","15","15","14","1","9","3.69"
"101692","29","29","26","3","18","3.69"
"102356","10","10","9","1","8","3.69"
"102424","16","16","16","0","10","3.69"
"102454","18","18","17","1","11","3.69"
"103059","16","16","14","2","12","3.69"
"103630","20","20","18","2","14","3.69"
"103665","11","11","9","2","8","3.69"
"103788","18","18","17","1","10","3.69"
"104073","20","20","19","1","12","3.69"
"104504","16","16","15","1","11","3.69"
"104507","18","18","14","4","11","3.69"
"104513","15","15","15","0","10","3.69"
"104869","11","11","9","2","9","3.69"
"105377","14","14","14","0","12","3.69"
"105469","14","14","12","2","10","3.69"
"106344","16","16","16","0","12","3.69"
"106409","19","19","17","2","11","3.69"
"106714","12","12","12","0","7","3.69"
"106891","13","13","12","1","10","3.69"
"107178","13","13","12","1","10","3.69"
"107577","21","21","19","2","12","3.69"
"107643","16","16","13","3","12","3.69"
"107791","22","21","22","0","15","3.69"
"108043","15","15","14","1","9","3.69"
"110042","16","16","16","0","10","3.69"
"110733","16","16","15","1","12","3.69"
"111115","13","13","11","2","9","3.69"
"111543","16","16","12","4","10","3.69"
"111901","19","19","17","2","12","3.69"
"112046","17","17","16","1","11","3.69"
"112487","14","14","13","1","10","3.69"
"113046","15","15","14","1","9","3.69"
"113243","22","22","18","4","13","3.69"
"113597","11","11","11","0","10","3.69"
"113713","12","12","10","2","8","3.69"
"114062","18","18","18","0","13","3.69"
"115267","12","12","11","1","9","3.69"
"115900","14","14","13","1","9","3.69"
"116833","19","19","17","2","12","3.69"
"117358","14","14","11","3","7","3.69"
"117433","17","17","15","2","11","3.69"
"100551","15","15","14","1","11","3.68"
"100687","19","19","19","0","14","3.68"
"102272","21","21","19","2","15","3.68"
"106291","13","13","12","1","11","3.68"
"107766","18","18","17","1","14","3.68"
"108745","12","12","12","0","11","3.68"
"109647","15","15","15","0","12","3.68"
"109710","19","19","18","1","14","3.68"
"110052","18","18","17","1","13","3.68"
"110829","23","23","21","2","14","3.68"
"110925","14","14","12","2","11","3.68"
"113328","18","18","17","1","13","3.68"
"115648","25","25","24","1","17","3.68"
"115669","20","20","18","2","14","3.68"
"100041","9","9","9","0","3","3.67"
"100133","9","9","9","0","4","3.67"
"100229","5","5","5","0","4","3.67"
"100261","12","12","12","0","7","3.67"
"100492","13","13","13","0","11","3.67"
"100748","15","15","14","1","8","3.67"
"100885","13","13","12","1","7","3.67"
"100935","9","9","9","0","5","3.67"
"100937","12","12","11","1","7","3.67"
"101001","13","13","12","1","8","3.67"
"101085","7","7","6","1","4","3.67"
"101091","7","7","7","0","4","3.67"
"101204","13","13","11","2","6","3.67"
"101224","9","9","7","2","6","3.67"
"101287","11","11","10","1","9","3.67"
"101370","11","11","10","1","4","3.67"
"101396","16","16","15","1","9","3.67"
"101475","20","20","20","0","14","3.67"
"101578","17","17","15","2","11","3.67"
"101645","17","17","14","3","10","3.67"
"101668","14","14","13","1","9","3.67"
"101735","14","14","12","2","9","3.67"
"101737","11","11","8","3","6","3.67"
"101780","13","13","12","1","7","3.67"
"101782","11","11","11","0","8","3.67"
"101787","9","9","8","1","7","3.67"
"101810","13","13","10","3","4","3.67"
"101830","16","16","14","2","9","3.67"
"101867","12","12","9","3","8","3.67"
"101916","12","12","12","0","9","3.67"
"101962","11","11","11","0","5","3.67"
"102149","11","11","11","0","8","3.67"
"102182","9","9","6","3","3","3.67"
"102264","16","16","15","1","10","3.67"
"102438","9","9","9","0","7","3.67"
"102463","9","9","9","0","7","3.67"
"102512","15","15","13","2","12","3.67"
"102541","13","13","12","1","8","3.67"
"102653","8","8","8","0","4","3.67"
"102675","15","15","13","2","7","3.67"
"102785","9","9","8","1","6","3.67"
"102942","13","13","12","1","9","3.67"
"102970","16","16","15","1","9","3.67"
"103001","10","10","9","1","8","3.67"
"103261","8","8","7","1","4","3.67"
"103354","10","10","9","1","7","3.67"
"103435","8","8","8","0","4","3.67"
"103505","16","16","15","1","3","3.67"
"103581","20","20","20","0","15","3.67"
"103688","14","14","12","2","7","3.67"
"103690","12","12","11","1","7","3.67"
"103793","10","10","10","0","7","3.67"
"103804","11","11","11","0","8","3.67"
"104240","9","9","5","4","3","3.67"
"104291","13","13","12","1","9","3.67"
"104314","19","19","17","2","11","3.67"
"104337","12","12","9","3","4","3.67"
"104358","16","16","15","1","11","3.67"
"104417","13","13","10","3","7","3.67"
"104501","16","16","15","1","11","3.67"
"104537","11","11","9","2","7","3.67"
"104671","13","13","12","1","12","3.67"
"104764","8","8","8","0","6","3.67"
"104894","15","15","13","2","9","3.67"
"104903","16","16","10","6","4","3.67"
"104943","14","14","12","2","9","3.67"
"105049","16","16","14","2","8","3.67"
"105068","12","12","11","1","7","3.67"
"105093","13","13","10","3","6","3.67"
"105136","12","12","9","3","4","3.67"
"105137","11","11","9","2","8","3.67"
"105139","10","10","10","0","7","3.67"
"105200","11","11","11","0","9","3.67"
"105266","14","14","13","1","6","3.67"
"105301","13","13","11","2","6","3.67"
"105385","9","9","7","2","4","3.67"
"105391","18","18","15","3","7","3.67"
"105459","7","7","6","1","3","3.67"
"105478","14","14","13","1","9","3.67"
"105761","12","12","9","3","3","3.67"
"105789","9","9","6","3","4","3.67"
"105809","17","17","15","2","10","3.67"
"105941","17","17","17","0","13","3.67"
"106006","11","11","10","1","10","3.67"
"106141","7","7","7","0","4","3.67"
"106198","9","9","9","0","3","3.67"
"106201","9","9","8","1","3","3.67"
"106262","18","18","16","2","12","3.67"
"106284","12","12","10","2","7","3.67"
"106340","15","15","15","0","12","3.67"
"106351","10","10","9","1","6","3.67"
"106360","10","10","10","0","7","3.67"
"106459","11","11","10","1","5","3.67"
"106488","15","15","11","4","7","3.67"
"106555","12","12","11","1","3","3.67"
"106562","11","11","11","0","7","3.67"
"106646","10","10","8","2","7","3.67"
"106755","18","18","15","3","9","3.67"
"106777","19","19","17","2","13","3.67"
"106786","15","15","12","3","9","3.67"
"106861","12","12","11","1","4","3.67"
"106872","12","12","11","1","8","3.67"
"107089","14","14","14","0","11","3.67"
"107148","12","12","12","0","7","3.67"
"107177","12","12","9","3","7","3.67"
"107188","13","13","12","1","10","3.67"
"107193","10","10","9","1","6","3.67"
"107273","7","7","6","1","3","3.67"
"107284","8","8","8","0","7","3.67"
"107341","19","19","16","3","10","3.67"
"107418","7","7","5","2","3","3.67"
"107450","13","13","9","4","8","3.67"
"107463","10","10","8","2","4","3.67"
"107470","12","12","12","0","11","3.67"
"107483","11","11","9","2","5","3.67"
"107579","14","14","11","3","6","3.67"
"107734","12","12","12","0","7","3.67"
"107838","9","9","8","1","3","3.67"
"107897","11","11","10","1","8","3.67"
"107901","13","13","12","1","9","3.67"
"108001","10","10","8","2","7","3.67"
"108109","14","14","13","1","10","3.67"
"108128","10","10","8","2","6","3.67"
"108201","15","15","14","1","12","3.67"
"108252","12","12","11","1","7","3.67"
"108265","18","18","18","0","14","3.67"
"108348","11","11","10","1","8","3.67"
"108447","18","18","18","0","12","3.67"
"108463","11","11","11","0","10","3.67"
"108543","12","12","11","1","6","3.67"
"108666","18","18","17","1","8","3.67"
"108838","18","18","17","1","11","3.67"
"108888","13","13","10","3","7","3.67"
"108891","19","19","17","2","12","3.67"
"108912","13","13","12","1","8","3.67"
"108973","14","14","12","2","6","3.67"
"109083","17","17","16","1","8","3.67"
"109175","15","15","13","2","12","3.67"
"109176","19","19","14","5","5","3.67"
"109259","6","6","6","0","3","3.67"
"109271","12","12","10","2","3","3.67"
"109279","11","11","9","2","6","3.67"
"109305","5","5","4","1","3","3.67"
"109401","16","16","12","4","8","3.67"
"109448","5","5","3","2","3","3.67"
"109580","8","8","7","1","3","3.67"
"109639","15","15","15","0","13","3.67"
"109810","8","8","8","0","6","3.67"
"109817","12","12","12","0","7","3.67"
"109972","8","8","8","0","6","3.67"
"109998","21","21","20","1","17","3.67"
"110312","12","12","12","0","8","3.67"
"110315","13","13","12","1","7","3.67"
"110377","10","10","9","1","8","3.67"
"110455","11","11","11","0","6","3.67"
"110506","8","8","7","1","5","3.67"
"110544","14","14","13","1","10","3.67"
"110610","16","16","16","0","9","3.67"
"110618","14","14","12","2","6","3.67"
"110675","21","21","19","2","12","3.67"
"110771","12","12","10","2","6","3.67"
"110785","14","14","12","2","8","3.67"
"110808","15","15","14","1","9","3.67"
"110921","12","12","12","0","8","3.67"
"111044","11","11","9","2","6","3.67"
"111118","14","14","14","0","8","3.67"
"111186","11","11","8","3","6","3.67"
"111384","19","19","17","2","9","3.67"
"111447","11","11","9","2","8","3.67"
"111453","8","8","6","2","3","3.67"
"111533","10","10","10","0","7","3.67"
"111743","8","8","6","2","3","3.67"
"111758","18","18","17","1","14","3.67"
"111762","12","12","10","2","8","3.67"
"111902","15","15","13","2","11","3.67"
"111905","11","11","10","1","8","3.67"
"112020","12","12","12","0","9","3.67"
"112045","12","12","11","1","7","3.67"
"112048","13","13","10","3","6","3.67"
"112125","16","16","15","1","11","3.67"
"112134","12","12","12","0","8","3.67"
"112190","11","11","10","1","8","3.67"
"112232","14","14","12","2","8","3.67"
"112320","14","14","11","3","8","3.67"
"112325","13","13","11","2","7","3.67"
"112345","9","9","9","0","6","3.67"
"112369","16","16","12","4","8","3.67"
"112414","14","14","11","3","9","3.67"
"112421","13","13","13","0","9","3.67"
"112446","8","8","8","0","6","3.67"
"112502","18","18","17","1","12","3.67"
"112508","15","15","10","5","8","3.67"
"112650","7","7","7","0","6","3.67"
"112680","16","16","15","1","7","3.67"
"112777","14","14","12","2","8","3.67"
"112920","14","14","11","3","8","3.67"
"112965","10","10","8","2","5","3.67"
"113024","13","13","13","0","8","3.67"
"113028","10","10","8","2","8","3.67"
"113143","21","21","18","3","11","3.67"
"113146","16","16","16","0","11","3.67"
"113159","19","19","17","2","13","3.67"
"113252","11","11","10","1","6","3.67"
"113254","16","16","14","2","8","3.67"
"113530","15","15","14","1","11","3.67"
"113563","7","7","7","0","3","3.67"
"113592","7","7","6","1","3","3.67"
"113630","15","15","14","1","10","3.67"
"113720","12","12","9","3","3","3.67"
"113777","17","17","14","3","8","3.67"
"113888","9","9","9","0","7","3.67"
"113899","14","14","12","2","8","3.67"
"113901","7","7","5","2","3","3.67"
"113934","14","14","12","2","7","3.67"
"113945","10","10","9","1","6","3.67"
"113955","9","9","7","2","3","3.67"
"114019","11","11","10","1","9","3.67"
"114037","5","5","4","1","3","3.67"
"114049","6","6","6","0","6","3.67"
"114057","7","7","7","0","6","3.67"
"114104","8","8","8","0","3","3.67"
"114145","8","8","8","0","3","3.67"
"114156","11","11","11","0","6","3.67"
"114461","13","13","12","1","8","3.67"
"114544","12","12","12","0","9","3.67"
"114558","11","11","11","0","8","3.67"
"114583","17","17","15","2","12","3.67"
"114989","9","9","8","1","7","3.67"
"115002","18","18","15","3","10","3.67"
"115066","10","10","5","5","4","3.67"
"115112","22","22","19","3","13","3.67"
"115258","11","11","8","3","4","3.67"
"115556","16","16","14","2","11","3.67"
"115736","14","14","13","1","10","3.67"
"115791","18","18","17","1","12","3.67"
"115884","9","9","9","0","6","3.67"
"115894","8","8","6","2","4","3.67"
"115986","8","8","8","0","4","3.67"
"116061","8","8","7","1","5","3.67"
"116070","8","8","6","2","3","3.67"
"116072","13","13","12","1","8","3.67"
"116086","19","19","19","0","15","3.67"
"116168","8","8","7","1","4","3.67"
"116294","9","9","8","1","5","3.67"
"116577","13","13","13","0","10","3.67"
"116619","15","15","14","1","9","3.67"
"116623","13","13","13","0","11","3.67"
"116638","16","16","14","2","9","3.67"
"116658","16","15","13","3","5","3.67"
"116707","12","12","11","1","9","3.67"
"116732","14","13","14","0","8","3.67"
"116761","14","14","10","4","3","3.67"
"116770","12","12","8","4","4","3.67"
"116810","7","7","6","1","3","3.67"
"116879","16","16","15","1","11","3.67"
"116897","18","18","14","4","9","3.67"
"116917","11","11","9","2","7","3.67"
"117046","6","6","6","0","4","3.67"
"117095","13","13","13","0","9","3.67"
"117271","10","10","9","1","9","3.67"
"117281","10","10","10","0","6","3.67"
"117352","8","8","6","2","6","3.67"
"100415","22","22","19","3","13","3.66"
"102597","17","17","15","2","13","3.66"
"102689","24","24","21","3","15","3.66"
"105012","19","18","19","0","13","3.66"
"105610","21","21","20","1","14","3.66"
"109173","19","19","16","3","12","3.66"
"112060","16","16","16","0","14","3.66"
"112510","24","23","18","6","16","3.66"
"117387","14","14","14","0","9","3.66"
"102333","17","17","15","2","9","3.65"
"102367","16","16","15","1","12","3.65"
"102375","19","19","18","1","13","3.65"
"102396","18","18","18","0","14","3.65"
"103476","13","13","12","1","9","3.65"
"104170","12","12","12","0","9","3.65"
"104957","20","20","17","3","15","3.65"
"105552","14","14","14","0","11","3.65"
"105577","17","17","16","1","13","3.65"
"108175","18","18","17","1","13","3.65"
"109310","12","12","11","1","9","3.65"
"109659","19","19","16","3","16","3.65"
"109711","14","14","13","1","10","3.65"
"111818","21","21","19","2","14","3.65"
"112351","14","14","12","2","8","3.65"
"112721","16","16","13","3","9","3.65"
"113116","20","20","19","1","15","3.65"
"114412","14","14","14","0","12","3.65"
"115998","17","17","16","1","11","3.65"
"116097","20","20","19","1","15","3.65"
"116537","17","17","15","2","12","3.65"
"100152","15","15","14","1","10","3.64"
"100802","15","15","15","0","12","3.64"
"100835","15","15","14","1","12","3.64"
"101199","11","11","10","1","8","3.64"
"102112","14","14","14","0","10","3.64"
"102131","12","11","11","1","10","3.64"
"102414","10","10","8","2","8","3.64"
"102696","18","18","18","0","11","3.64"
"104158","14","14","13","1","11","3.64"
"104188","15","15","13","2","9","3.64"
"104199","10","10","10","0","8","3.64"
"104306","11","11","10","1","9","3.64"
"104374","11","11","11","0","9","3.64"
"104481","15","15","13","2","11","3.64"
"104530","13","13","12","1","10","3.64"
"104655","23","23","22","1","15","3.64"
"104699","14","14","12","2","8","3.64"
"104793","14","14","14","0","10","3.64"
"104813","15","15","13","2","9","3.64"
"104953","13","13","11","2","11","3.64"
"104964","18","18","17","1","11","3.64"
"104974","13","13","12","1","8","3.64"
"105294","22","22","22","0","16","3.64"
"105386","20","20","20","0","12","3.64"
"106039","17","17","16","1","11","3.64"
"106381","18","18","18","0","13","3.64"
"106437","17","17","14","3","9","3.64"
"106662","14","14","12","2","10","3.64"
"106761","15","15","13","2","11","3.64"
"106837","17","17","16","1","11","3.64"
"106932","16","16","13","3","11","3.64"
"106944","13","13","12","1","10","3.64"
"107336","19","19","17","2","12","3.64"
"107419","16","16","15","1","9","3.64"
"107506","17","17","12","5","9","3.64"
"107511","16","16","16","0","9","3.64"
"107519","17","17","15","2","10","3.64"
"108018","15","15","15","0","13","3.64"
"108431","18","18","14","4","10","3.64"
"108751","13","13","10","3","8","3.64"
"108887","12","12","11","1","10","3.64"
"109041","11","11","11","0","9","3.64"
"109342","15","15","15","0","11","3.64"
"109542","14","14","13","1","11","3.64"
"109564","20","20","17","3","12","3.64"
"109623","14","14","13","1","9","3.64"
"109783","13","13","13","0","10","3.64"
"109967","15","15","13","2","10","3.64"
"110318","19","19","17","2","12","3.64"
"110712","21","21","18","3","11","3.64"
"110939","15","15","15","0","10","3.64"
"111123","11","11","9","2","8","3.64"
"111643","22","22","20","2","10","3.64"
"112180","14","14","11","3","8","3.64"
"112206","17","17","14","3","10","3.64"
"112283","12","12","10","2","8","3.64"
"113048","10","10","9","1","8","3.64"
"113196","14","14","13","1","10","3.64"
"113351","18","18","17","1","10","3.64"
"114171","10","10","9","1","8","3.64"
"114235","14","14","14","0","10","3.64"
"114368","16","16","15","1","11","3.64"
"114661","16","16","14","2","12","3.64"
"114936","13","13","11","2","8","3.64"
"115185","15","15","15","0","11","3.64"
"115940","13","13","11","2","8","3.64"
"117184","14","14","14","0","9","3.64"
"117230","16","16","13","3","8","3.64"
"117438","17","17","16","1","11","3.64"
"100137","13","13","9","4","7","3.63"
"100629","20","19","19","1","16","3.63"
"100920","16","16","13","3","11","3.63"
"101029","16","16","14","2","10","3.63"
"101128","12","12","11","1","7","3.63"
"101276","11","11","11","0","9","3.63"
"101297","16","16","15","1","10","3.63"
"101333","15","15","14","1","10","3.63"
"101358","13","13","11","2","7","3.63"
"101557","7","7","6","1","5","3.63"
"101581","15","15","15","0","8","3.63"
"101633","9","9","8","1","5","3.63"
"101745","16","16","13","3","10","3.63"
"101784","17","17","15","2","13","3.63"
"101847","12","12","10","2","6","3.63"
"101944","7","7","7","0","5","3.63"
"102114","10","10","8","2","8","3.63"
"102179","13","13","12","1","7","3.63"
"102256","15","15","15","0","12","3.63"
"102779","15","15","14","1","13","3.63"
"102801","18","18","13","5","5","3.63"
"102880","14","14","13","1","11","3.63"
"102907","14","14","13","1","9","3.63"
"103204","12","12","12","0","5","3.63"
"103555","14","14","12","2","9","3.63"
"103907","20","20","19","1","11","3.63"
"103941","17","17","16","1","10","3.63"
"104169","19","19","18","1","11","3.63"
"104180","13","13","12","1","7","3.63"
"104525","14","14","12","2","8","3.63"
"104573","10","10","9","1","5","3.63"
"104595","19","19","19","0","12","3.63"
"104689","23","23","20","3","12","3.63"
"104859","15","15","13","2","12","3.63"
"104979","12","12","11","1","5","3.63"
"105189","10","10","9","1","6","3.63"
"105311","23","23","21","2","13","3.63"
"105417","12","12","12","0","9","3.63"
"105517","15","15","15","0","9","3.63"
"105538","19","19","17","2","12","3.63"
"105575","22","21","16","6","14","3.63"
"105648","9","9","8","1","6","3.63"
"105653","17","17","15","2","14","3.63"
"105777","14","14","13","1","10","3.63"
"106035","12","12","12","0","10","3.63"
"106046","13","13","11","2","6","3.63"
"106061","10","10","9","1","5","3.63"
"106065","14","14","10","4","5","3.63"
"106147","11","11","9","2","6","3.63"
"106320","11","11","10","1","7","3.63"
"106362","7","7","6","1","6","3.63"
"106480","7","7","7","0","5","3.63"
"106744","8","8","7","1","6","3.63"
"106907","16","16","15","1","11","3.63"
"106911","17","17","15","2","7","3.63"
"106998","11","11","10","1","7","3.63"
"107124","18","18","17","1","13","3.63"
"107216","12","12","9","3","5","3.63"
"107319","15","15","11","4","6","3.63"
"107353","18","18","17","1","13","3.63"
"107716","12","12","10","2","5","3.63"
"107810","11","11","9","2","5","3.63"
"107933","13","13","12","1","8","3.63"
"107971","19","19","17","2","14","3.63"
"108069","14","14","12","2","11","3.63"
"108307","15","15","13","2","5","3.63"
"108309","17","17","14","3","10","3.63"
"108637","17","17","15","2","8","3.63"
"108832","15","15","14","1","11","3.63"
"109110","11","11","11","0","8","3.63"
"109119","13","13","9","4","5","3.63"
"109349","9","9","8","1","6","3.63"
"109467","19","19","17","2","13","3.63"
"109642","8","8","7","1","5","3.63"
"109645","18","18","16","2","13","3.63"
"110007","17","17","16","1","9","3.63"
"110253","9","9","8","1","5","3.63"
"110301","13","13","13","0","9","3.63"
"110552","18","18","15","3","11","3.63"
"110789","9","9","8","1","6","3.63"
"111302","14","14","12","2","5","3.63"
"111303","10","10","9","1","5","3.63"
"111451","9","9","8","1","5","3.63"
"111603","10","10","9","1","5","3.63"
"111880","15","15","13","2","6","3.63"
"111909","11","11","11","0","5","3.63"
"111927","13","13","13","0","9","3.63"
"112019","10","10","10","0","8","3.63"
"112024","19","19","16","3","9","3.63"
"112244","6","6","6","0","5","3.63"
"112281","11","11","10","1","5","3.63"
"112332","14","14","12","2","10","3.63"
"112339","13","13","12","1","7","3.63"
"112357","23","23","22","1","15","3.63"
"112405","16","16","13","3","8","3.63"
"112455","15","15","14","1","6","3.63"
"112516","13","13","13","0","6","3.63"
"112672","17","17","16","1","11","3.63"
"112808","12","12","9","3","6","3.63"
"112886","18","18","16","2","13","3.63"
"113052","14","14","10","4","6","3.63"
"113149","11","11","10","1","9","3.63"
"113288","7","7","7","0","5","3.63"
"113318","14","14","12","2","9","3.63"
"113358","11","11","9","2","5","3.63"
"113440","9","9","8","1","5","3.63"
"114256","8","8","7","1","5","3.63"
"114323","10","10","9","1","8","3.63"
"114337","16","16","13","3","10","3.63"
"114474","12","12","11","1","6","3.63"
"114715","13","13","13","0","9","3.63"
"114756","13","13","11","2","9","3.63"
"114834","12","12","12","0","5","3.63"
"115257","14","14","13","1","8","3.63"
"115440","14","14","13","1","5","3.63"
"115464","13","13","11","2","6","3.63"
"115584","14","14","14","0","11","3.63"
"115825","13","13","13","0","8","3.63"
"115833","20","20","17","3","12","3.63"
"115870","9","9","9","0","6","3.63"
"116071","9","9","8","1","5","3.63"
"116076","13","13","13","0","10","3.63"
"116164","13","13","13","0","9","3.63"
"116295","14","14","13","1","10","3.63"
"116319","15","15","12","3","8","3.63"
"116372","14","14","11","3","6","3.63"
"116480","14","14","10","4","7","3.63"
"116738","13","13","10","3","5","3.63"
"116846","10","10","10","0","6","3.63"
"116912","14","14","12","2","6","3.63"
"117166","11","11","11","0","9","3.63"
"117256","14","14","10","4","5","3.63"
"117342","14","14","12","2","10","3.63"
"117535","22","22","19","3","13","3.63"
"117606","10","10","8","2","7","3.63"
"100123","15","15","15","0","13","3.62"
"100310","21","21","20","1","18","3.62"
"101802","22","22","20","2","10","3.62"
"102478","18","18","18","0","11","3.62"
"102809","14","14","13","1","9","3.62"
"103373","19","19","18","1","16","3.62"
"103473","17","17","17","0","11","3.62"
"104340","18","18","15","3","11","3.62"
"104631","21","21","18","3","15","3.62"
"104779","12","12","12","0","10","3.62"
"105985","15","15","14","1","13","3.62"
"106407","17","17","16","1","9","3.62"
"106908","16","16","14","2","12","3.62"
"107279","12","12","12","0","10","3.62"
"108024","14","14","12","2","10","3.62"
"108489","19","19","17","2","12","3.62"
"108909","14","14","14","0","12","3.62"
"110499","17","17","17","0","13","3.62"
"110987","16","16","14","2","11","3.62"
"112054","14","14","14","0","13","3.62"
"112907","20","20","20","0","13","3.62"
"113410","15","15","14","1","11","3.62"
"114895","12","12","12","0","10","3.62"
"115828","19","19","19","0","14","3.62"
"116543","15","15","15","0","10","3.62"
"100196","15","15","14","1","11","3.61"
"100585","21","21","19","2","12","3.61"
"100815","17","17","16","1","14","3.61"
"100906","17","17","16","1","12","3.61"
"100976","13","13","12","1","12","3.61"
"100982","15","15","11","4","9","3.61"
"101149","20","20","16","4","11","3.61"
"101498","12","12","12","0","11","3.61"
"101805","14","14","13","1","12","3.61"
"101865","16","16","15","1","12","3.61"
"102775","19","19","17","2","12","3.61"
"102791","12","12","11","1","8","3.61"
"102850","18","18","17","1","11","3.61"
"103632","20","20","19","1","14","3.61"
"103749","18","18","17","1","13","3.61"
"103797","16","16","14","2","8","3.61"
"103990","15","15","15","0","11","3.61"
"104726","18","18","18","0","10","3.61"
"105924","16","16","14","2","10","3.61"
"105934","12","12","12","0","11","3.61"
"106173","15","15","15","0","12","3.61"
"106302","10","10","9","1","7","3.61"
"106642","15","15","15","0","8","3.61"
"106902","12","12","11","1","6","3.61"
"108227","15","15","14","1","9","3.61"
"108722","12","12","11","1","9","3.61"
"108877","8","8","8","0","6","3.61"
"109438","18","18","16","2","11","3.61"
"109585","23","23","20","3","13","3.61"
"110380","14","14","12","2","8","3.61"
"111142","12","12","12","0","8","3.61"
"111772","14","14","11","3","6","3.61"
"112076","12","12","9","3","8","3.61"
"112184","17","17","15","2","8","3.61"
"112294","14","14","14","0","10","3.61"
"112413","13","13","13","0","11","3.61"
"112832","19","19","16","3","12","3.61"
"112911","16","16","16","0","11","3.61"
"113632","19","19","19","0","16","3.61"
"113705","17","17","14","3","10","3.61"
"114038","19","19","18","1","16","3.61"
"114272","17","17","15","2","13","3.61"
"114656","9","9","8","1","6","3.61"
"114830","15","15","11","4","8","3.61"
"115081","18","18","15","3","10","3.61"
"115513","13","13","13","0","9","3.61"
"116584","19","19","17","2","13","3.61"
"117273","14","14","14","0","9","3.61"
"117484","14","14","12","2","8","3.61"
"117566","12","12","9","3","6","3.61"
"117584","19","19","18","1","16","3.61"
"100187","12","12","11","1","8","3.60"
"100296","16","16","13","3","9","3.60"
"100609","15","15","14","1","6","3.60"
"100752","11","11","8","3","7","3.60"
"100780","11","11","9","2","6","3.60"
"100878","18","18","15","3","12","3.60"
"100966","16","16","13","3","10","3.60"
"101113","11","11","11","0","7","3.60"
"101407","17","17","15","2","8","3.60"
"101540","13","13","12","1","8","3.60"
"101640","8","8","8","0","6","3.60"
"101641","18","18","16","2","12","3.60"
"101719","12","12","12","0","11","3.60"
"102241","13","13","10","3","9","3.60"
"102680","14","14","11","3","9","3.60"
"102828","17","17","17","0","13","3.60"
"102839","13","13","13","0","9","3.60"
"102895","11","11","9","2","6","3.60"
"102902","11","11","9","2","7","3.60"
"102961","9","9","9","0","5","3.60"
"103067","13","13","11","2","8","3.60"
"103328","9","9","8","1","6","3.60"
"103362","8","8","8","0","7","3.60"
"103379","10","10","10","0","8","3.60"
"103491","18","18","14","4","7","3.60"
"103511","11","11","11","0","9","3.60"
"103655","14","14","12","2","8","3.60"
"103666","12","12","9","3","6","3.60"
"103764","7","7","6","1","5","3.60"
"103871","14","14","13","1","12","3.60"
"103948","14","14","9","5","8","3.60"
"103982","12","12","12","0","8","3.60"
"103987","12","12","11","1","8","3.60"
"104041","21","21","20","1","17","3.60"
"104078","11","11","11","0","8","3.60"
"104192","11","11","10","1","7","3.60"
"104278","13","13","11","2","5","3.60"
"104370","13","13","12","1","6","3.60"
"104378","9","9","9","0","7","3.60"
"104381","13","13","12","1","10","3.60"
"104426","15","15","14","1","8","3.60"
"104505","15","15","12","3","7","3.60"
"104634","11","11","10","1","7","3.60"
"104673","13","13","11","2","6","3.60"
"104717","15","15","13","2","7","3.60"
"104721","15","15","14","1","5","3.60"
"104890","13","13","11","2","8","3.60"
"105034","9","9","9","0","8","3.60"
"105052","15","15","14","1","11","3.60"
"105103","14","14","12","2","6","3.60"
"105450","14","14","12","2","9","3.60"
"105531","10","10","8","2","5","3.60"
"105537","16","16","13","3","7","3.60"
"105573","12","12","10","2","6","3.60"
"105612","10","10","9","1","6","3.60"
"105650","11","11","10","1","7","3.60"
"105984","12","12","11","1","6","3.60"
"106076","16","16","15","1","12","3.60"
"106212","19","19","16","3","12","3.60"
"106220","13","13","12","1","7","3.60"
"106245","14","14","13","1","7","3.60"
"106299","20","20","17","3","12","3.60"
"106447","9","9","6","3","5","3.60"
"106527","11","11","10","1","5","3.60"
"106597","17","17","16","1","15","3.60"
"106924","10","10","9","1","5","3.60"
"106939","15","15","11","4","6","3.60"
"106970","14","14","13","1","7","3.60"
"107033","12","12","10","2","5","3.60"
"107289","11","11","7","4","5","3.60"
"107376","19","19","17","2","9","3.60"
"107415","12","12","9","3","7","3.60"
"107493","24","24","22","2","11","3.60"
"107660","17","17","17","0","12","3.60"
"107715","11","11","10","1","8","3.60"
"107731","12","12","9","3","7","3.60"
"107773","10","10","9","1","8","3.60"
"108221","12","12","10","2","6","3.60"
"108310","13","13","12","1","9","3.60"
"108488","13","13","13","0","8","3.60"
"108494","15","15","11","4","7","3.60"
"108619","15","15","11","4","9","3.60"
"108781","14","14","14","0","12","3.60"
"108831","12","12","11","1","8","3.60"
"109149","8","8","8","0","6","3.60"
"109183","23","23","22","1","15","3.60"
"109388","10","10","7","3","6","3.60"
"109600","9","9","8","1","6","3.60"
"109866","12","12","9","3","5","3.60"
"110116","20","20","18","2","12","3.60"
"110213","13","13","12","1","7","3.60"
"110257","14","14","13","1","6","3.60"
"110322","10","10","10","0","5","3.60"
"110369","15","15","14","1","7","3.60"
"110391","14","14","14","0","6","3.60"
"110433","14","14","14","0","6","3.60"
"110681","17","17","15","2","7","3.60"
"110873","21","21","18","3","14","3.60"
"110978","13","13","13","0","5","3.60"
"111045","9","9","8","1","6","3.60"
"111070","13","13","12","1","6","3.60"
"111200","15","15","13","2","7","3.60"
"111239","6","6","6","0","5","3.60"
"111299","10","10","8","2","6","3.60"
"111409","18","18","15","3","9","3.60"
"111454","17","17","15","2","12","3.60"
"111488","8","8","7","1","6","3.60"
"111537","10","10","9","1","7","3.60"
"111605","11","11","9","2","6","3.60"
"111690","9","9","7","2","7","3.60"
"111804","11","11","11","0","8","3.60"
"111953","12","12","12","0","7","3.60"
"112009","10","10","9","1","6","3.60"
"112059","12","12","11","1","8","3.60"
"112100","17","17","14","3","9","3.60"
"112112","11","11","8","3","6","3.60"
"112181","13","13","13","0","10","3.60"
"112272","15","15","15","0","9","3.60"
"112486","17","17","16","1","14","3.60"
"112824","11","11","9","2","5","3.60"
"112897","10","10","10","0","7","3.60"
"112956","11","11","11","0","9","3.60"
"112973","8","8","8","0","6","3.60"
"113089","13","13","11","2","8","3.60"
"113209","12","12","10","2","7","3.60"
"113224","13","13","10","3","6","3.60"
"113234","10","10","8","2","5","3.60"
"113581","8","8","8","0","5","3.60"
"113776","14","14","13","1","12","3.60"
"113891","12","12","8","4","5","3.60"
"114015","15","15","13","2","7","3.60"
"114048","12","12","11","1","7","3.60"
"114549","12","12","12","0","6","3.60"
"114560","11","11","9","2","8","3.60"
"114600","16","15","16","0","12","3.60"
"114606","14","14","14","0","7","3.60"
"114609","8","8","6","2","5","3.60"
"114678","9","9","7","2","5","3.60"
"114700","11","11","10","1","8","3.60"
"114703","10","10","10","0","5","3.60"
"114716","17","17","15","2","13","3.60"
"114735","17","17","13","4","6","3.60"
"114876","17","17","14","3","8","3.60"
"114921","10","10","10","0","6","3.60"
"115249","17","17","13","4","6","3.60"
"115305","17","17","16","1","11","3.60"
"115324","14","14","14","0","10","3.60"
"115347","13","13","12","1","8","3.60"
"115466","11","11","9","2","8","3.60"
"115479","9","9","7","2","6","3.60"
"115547","14","14","13","1","7","3.60"
"115558","14","14","13","1","12","3.60"
"115574","15","15","13","2","8","3.60"
"115654","8","8","7","1","6","3.60"
"115761","13","13","11","2","5","3.60"
"115770","8","8","7","1","5","3.60"
"115845","15","15","14","1","11","3.60"
"115926","13","13","12","1","8","3.60"
"115958","7","7","7","0","6","3.60"
"115997","11","11","10","1","6","3.60"
"116032","15","15","13","2","7","3.60"
"116094","12","12","11","1","8","3.60"
"116171","10","10","10","0","7","3.60"
"116197","10","10","10","0","5","3.60"
"116209","5","5","5","0","5","3.60"
"116380","11","11","9","2","8","3.60"
"116522","10","10","10","0","9","3.60"
"116719","11","11","11","0","8","3.60"
"116740","9","9","8","1","5","3.60"
"116752","12","12","11","1","6","3.60"
"116868","13","13","11","2","6","3.60"
"116954","15","15","14","1","8","3.60"
"117306","12","12","10","2","8","3.60"
"117364","13","13","11","2","6","3.60"
"117414","10","10","9","1","7","3.60"
"117489","10","10","9","1","7","3.60"
"117511","14","14","12","2","8","3.60"
"117569","13","13","11","2","8","3.60"
"100578","22","22","19","3","13","3.59"
"101290","19","19","18","1","13","3.59"
"102344","20","20","17","3","12","3.59"
"105487","18","18","17","1","12","3.59"
"105609","17","17","15","2","12","3.59"
"110010","20","20","19","1","14","3.59"
"110434","18","18","18","0","9","3.59"
"110844","17","17","16","1","11","3.59"
"113021","18","18","16","2","13","3.59"
"113087","18","18","17","1","13","3.59"
"113492","17","17","17","0","14","3.59"
"114698","13","13","12","1","9","3.59"
"116565","20","20","14","6","12","3.59"
"100050","15","15","13","2","11","3.58"
"100135","13","13","9","4","8","3.58"
"100175","17","17","14","3","12","3.58"
"100190","15","15","13","2","11","3.58"
"100241","10","10","10","0","6","3.58"
"100339","19","19","19","0","16","3.58"
"100654","12","12","12","0","7","3.58"
"100683","16","16","15","1","11","3.58"
"100849","15","15","15","0","12","3.58"
"100853","15","15","15","0","7","3.58"
"100898","16","16","15","1","8","3.58"
"100977","25","25","24","1","19","3.58"
"101163","16","16","15","1","10","3.58"
"101686","8","8","7","1","7","3.58"
"101815","18","18","15","3","12","3.58"
"101899","15","15","13","2","8","3.58"
"101929","8","8","7","1","6","3.58"
"102012","14","14","11","3","7","3.58"
"102555","14","14","13","1","8","3.58"
"102623","14","14","14","0","13","3.58"
"103015","12","12","10","2","9","3.58"
"103033","12","12","11","1","6","3.58"
"103194","14","14","13","1","9","3.58"
"103270","15","15","15","0","8","3.58"
"103463","22","22","19","3","10","3.58"
"103571","17","17","13","4","10","3.58"
"103724","11","11","9","2","6","3.58"
"103836","11","11","10","1","8","3.58"
"103883","9","9","8","1","8","3.58"
"103901","17","17","17","0","12","3.58"
"103973","17","17","15","2","12","3.58"
"104025","13","13","12","1","6","3.58"
"104265","9","9","9","0","8","3.58"
"104401","10","10","9","1","6","3.58"
"104474","13","13","11","2","9","3.58"
"104707","10","10","10","0","7","3.58"
"104995","13","13","13","0","7","3.58"
"105122","12","12","12","0","9","3.58"
"105152","14","14","13","1","7","3.58"
"105281","14","14","14","0","7","3.58"
"105323","13","13","12","1","9","3.58"
"105416","18","18","17","1","11","3.58"
"105683","16","16","16","0","13","3.58"
"105759","13","13","12","1","9","3.58"
"105836","12","12","11","1","9","3.58"
"106144","15","15","14","1","9","3.58"
"106365","15","15","15","0","12","3.58"
"106789","11","11","9","2","6","3.58"
"106913","15","15","13","2","6","3.58"
"107122","10","10","8","2","7","3.58"
"107255","19","19","18","1","13","3.58"
"107738","16","16","12","4","10","3.58"
"108415","17","17","15","2","10","3.58"
"108510","16","16","14","2","10","3.58"
"108579","15","15","13","2","12","3.58"
"108606","19","19","16","3","13","3.58"
"108610","15","15","14","1","10","3.58"
"108674","14","14","11","3","9","3.58"
"108854","14","14","13","1","9","3.58"
"108939","13","13","10","3","8","3.58"
"108995","19","19","17","2","9","3.58"
"109230","13","13","11","2","6","3.58"
"109319","11","11","10","1","7","3.58"
"109320","18","18","17","1","11","3.58"
"109454","12","12","11","1","7","3.58"
"109638","11","11","11","0","8","3.58"
"109785","15","15","13","2","8","3.58"
"109971","11","11","10","1","8","3.58"
"110164","14","14","12","2","9","3.58"
"110188","16","16","16","0","11","3.58"
"110252","14","14","12","2","7","3.58"
"110256","9","9","8","1","7","3.58"
"110580","11","11","10","1","7","3.58"
"110621","22","22","21","1","15","3.58"
"110663","12","12","10","2","9","3.58"
"111016","10","10","9","1","8","3.58"
"111139","13","13","13","0","8","3.58"
"111162","12","12","11","1","7","3.58"
"111238","12","12","9","3","8","3.58"
"111249","14","14","14","0","8","3.58"
"111667","11","11","10","1","9","3.58"
"111721","10","10","9","1","7","3.58"
"111768","11","11","11","0","9","3.58"
"111835","11","11","10","1","8","3.58"
"111857","11","11","10","1","8","3.58"
"111867","15","15","13","2","9","3.58"
"111910","13","13","11","2","8","3.58"
"112363","10","10","8","2","7","3.58"
"112655","14","14","14","0","10","3.58"
"112796","11","11","11","0","7","3.58"
"112865","10","10","9","1","6","3.58"
"113053","12","12","12","0","7","3.58"
"113331","20","20","17","3","12","3.58"
"113416","13","13","13","0","7","3.58"
"113528","12","12","11","1","7","3.58"
"113661","11","11","10","1","6","3.58"
"113944","18","18","17","1","14","3.58"
"113950","14","14","14","0","9","3.58"
"114138","23","23","21","2","17","3.58"
"114313","16","16","14","2","9","3.58"
"114512","16","16","12","4","11","3.58"
"114653","17","17","14","3","8","3.58"
"114654","18","18","17","1","11","3.58"
"114845","18","18","18","0","9","3.58"
"114919","14","14","11","3","9","3.58"
"114961","19","19","15","4","11","3.58"
"115095","15","15","12","3","8","3.58"
"115159","13","13","10","3","8","3.58"
"115228","9","9","8","1","7","3.58"
"115253","10","10","8","2","8","3.58"
"115254","12","12","11","1","10","3.58"
"115414","16","16","15","1","9","3.58"
"115425","12","12","12","0","9","3.58"
"115674","16","16","12","4","8","3.58"
"115741","14","14","12","2","8","3.58"
"115854","16","16","16","0","9","3.58"
"115866","9","9","9","0","6","3.58"
"115948","18","18","17","1","13","3.58"
"115973","11","11","8","3","7","3.58"
"116011","11","11","11","0","7","3.58"
"116247","15","15","14","1","11","3.58"
"116279","12","12","10","2","8","3.58"
"116405","15","15","13","2","9","3.58"
"116417","12","12","11","1","7","3.58"
"116419","14","14","13","1","10","3.58"
"116454","20","20","19","1","13","3.58"
"116495","16","16","13","3","7","3.58"
"116720","17","17","16","1","12","3.58"
"116786","15","15","13","2","12","3.58"
"116838","13","13","13","0","9","3.58"
"117085","15","15","13","2","10","3.58"
"117181","16","16","12","4","8","3.58"
"117383","13","13","11","2","10","3.58"
"117419","22","22","20","2","9","3.58"
"117469","12","12","9","3","8","3.58"
"117486","13","13","12","1","7","3.58"
"117497","12","12","10","2","7","3.58"
"117518","13","13","11","2","8","3.58"
"117564","15","15","11","4","6","3.58"
"117581","17","17","15","2","10","3.58"
"100039","22","22","21","1","15","3.57"
"100189","19","19","18","1","12","3.57"
"100449","12","12","12","0","8","3.57"
"100488","17","17","14","3","8","3.57"
"100932","12","12","10","2","8","3.57"
"101176","11","11","11","0","9","3.57"
"101262","13","13","12","1","10","3.57"
"101375","8","8","8","0","7","3.57"
"101571","13","13","12","1","10","3.57"
"101636","19","19","19","0","10","3.57"
"101747","14","14","13","1","10","3.57"
"101903","17","17","16","1","9","3.57"
"102082","14","14","12","2","9","3.57"
"102168","15","15","12","3","9","3.57"
"102587","13","13","13","0","9","3.57"
"102853","17","17","15","2","11","3.57"
"102979","18","18","16","2","8","3.57"
"103242","16","16","13","3","11","3.57"
"103485","14","14","13","1","9","3.57"
"103564","20","20","19","1","14","3.57"
"103787","18","18","14","4","9","3.57"
"103830","23","23","21","2","12","3.57"
"103875","16","16","14","2","8","3.57"
"104019","17","17","17","0","9","3.57"
"104024","21","21","17","4","8","3.57"
"104088","12","12","12","0","9","3.57"
"104398","16","16","14","2","11","3.57"
"104544","14","14","13","1","10","3.57"
"104628","10","10","9","1","7","3.57"
"104804","19","19","17","2","13","3.57"
"104866","13","13","12","1","10","3.57"
"104932","14","14","12","2","7","3.57"
"105142","14","14","13","1","8","3.57"
"105392","12","12","12","0","10","3.57"
"105455","16","16","15","1","9","3.57"
"105488","16","16","16","0","11","3.57"
"105509","17","17","15","2","8","3.57"
"105792","19","19","18","1","11","3.57"
"105807","14","14","14","0","11","3.57"
"106074","17","17","15","2","9","3.57"
"106256","19","19","19","0","10","3.57"
"106322","10","10","10","0","8","3.57"
"106539","11","11","11","0","8","3.57"
"106594","20","20","18","2","13","3.57"
"106651","13","13","11","2","8","3.57"
"106738","12","12","10","2","7","3.57"
"106792","13","13","12","1","9","3.57"
"106851","10","10","10","0","9","3.57"
"106999","11","11","11","0","10","3.57"
"107187","18","18","14","4","12","3.57"
"107275","12","12","10","2","8","3.57"
"107567","16","16","14","2","10","3.57"
"107618","11","11","11","0","10","3.57"
"107685","14","14","13","1","8","3.57"
"107813","14","14","11","3","7","3.57"
"107888","17","17","17","0","9","3.57"
"107936","18","18","17","1","9","3.57"
"108057","16","16","16","0","9","3.57"
"108059","16","16","15","1","11","3.57"
"108352","13","13","11","2","8","3.57"
"108682","18","18","14","4","9","3.57"
"108813","20","20","16","4","9","3.57"
"108849","24","24","22","2","18","3.57"
"109140","19","19","19","0","14","3.57"
"109169","13","13","11","2","8","3.57"
"109756","16","16","15","1","11","3.57"
"110187","16","16","12","4","8","3.57"
"110267","16","16","15","1","11","3.57"
"110319","12","12","10","2","7","3.57"
"110464","14","14","13","1","8","3.57"
"110598","14","14","14","0","8","3.57"
"110839","16","16","13","3","9","3.57"
"110854","16","16","15","1","12","3.57"
"110955","14","14","14","0","10","3.57"
"111295","12","12","12","0","9","3.57"
"111323","14","14","12","2","8","3.57"
"111330","20","20","16","4","12","3.57"
"111653","15","15","14","1","13","3.57"
"111759","13","13","12","1","8","3.57"
"112036","13","13","13","0","8","3.57"
"112120","12","12","11","1","9","3.57"
"112133","18","18","15","3","9","3.57"
"112217","17","17","17","0","12","3.57"
"112301","14","14","13","1","9","3.57"
"112364","15","15","14","1","9","3.57"
"112498","13","13","13","0","11","3.57"
"112563","17","17","16","1","13","3.57"
"112648","14","13","14","0","12","3.57"
"112688","12","12","11","1","9","3.57"
"112941","20","20","19","1","12","3.57"
"113105","12","12","11","1","8","3.57"
"113124","15","15","15","0","12","3.57"
"113249","19","19","18","1","11","3.57"
"113276","18","18","17","1","14","3.57"
"113466","13","13","12","1","9","3.57"
"113827","17","17","16","1","10","3.57"
"114229","11","11","9","2","7","3.57"
"114233","21","21","18","3","15","3.57"
"114434","21","21","20","1","15","3.57"
"114564","17","17","16","1","11","3.57"
"114655","11","11","11","0","8","3.57"
"114736","16","16","13","3","9","3.57"
"114798","11","11","9","2","7","3.57"
"114869","11","11","9","2","7","3.57"
"114924","18","18","15","3","12","3.57"
"114954","13","13","12","1","8","3.57"
"115133","16","16","15","1","13","3.57"
"115176","16","16","13","3","8","3.57"
"115620","17","17","14","3","9","3.57"
"115840","20","20","18","2","13","3.57"
"116017","15","15","13","2","7","3.57"
"116130","11","11","10","1","8","3.57"
"116198","18","18","16","2","12","3.57"
"116205","11","11","11","0","11","3.57"
"116452","15","15","14","1","7","3.57"
"116765","12","12","12","0","8","3.57"
"116971","12","12","11","1","7","3.57"
"117351","13","13","12","1","8","3.57"
"100259","16","16","12","4","9","3.56"
"100397","13","13","13","0","10","3.56"
"100420","14","14","12","2","9","3.56"
"100847","15","15","14","1","9","3.56"
"100959","22","22","18","4","10","3.56"
"101525","13","13","12","1","10","3.56"
"101544","16","16","16","0","13","3.56"
"101790","12","12","12","0","9","3.56"
"102063","15","15","12","3","9","3.56"
"102747","10","10","10","0","6","3.56"
"102914","18","18","16","2","11","3.56"
"103023","21","21","17","4","12","3.56"
"103073","21","21","21","0","15","3.56"
"103105","15","15","12","3","5","3.56"
"103356","14","14","12","2","9","3.56"
"103584","9","9","9","0","8","3.56"
"103698","15","15","13","2","12","3.56"
"103855","12","12","9","3","9","3.56"
"104249","14","14","12","2","8","3.56"
"104404","17","17","16","1","11","3.56"
"104427","19","19","18","1","12","3.56"
"104491","20","20","17","3","16","3.56"
"104564","19","19","17","2","11","3.56"
"104697","19","19","18","1","13","3.56"
"104818","14","14","13","1","10","3.56"
"104826","17","17","17","0","13","3.56"
"105073","19","19","13","6","9","3.56"
"105114","16","16","15","1","9","3.56"
"105186","17","17","17","0","12","3.56"
"105250","12","12","12","0","10","3.56"
"105691","17","17","16","1","12","3.56"
"105824","18","18","14","4","12","3.56"
"105928","14","14","14","0","9","3.56"
"106181","11","11","11","0","10","3.56"
"106443","17","17","15","2","10","3.56"
"106803","14","14","12","2","9","3.56"
"106873","14","14","12","2","6","3.56"
"107430","18","18","15","3","14","3.56"
"107596","12","12","9","3","5","3.56"
"107677","19","19","14","5","10","3.56"
"107717","12","12","12","0","9","3.56"
"107748","17","17","16","1","13","3.56"
"108194","10","10","9","1","6","3.56"
"108323","19","19","15","4","12","3.56"
"108433","16","16","12","4","9","3.56"
"108712","20","20","14","6","10","3.56"
"108760","14","14","12","2","9","3.56"
"109065","14","14","9","5","8","3.56"
"109154","13","13","13","0","10","3.56"
"109205","18","18","18","0","14","3.56"
"109280","15","15","13","2","11","3.56"
"110130","13","13","11","2","9","3.56"
"110200","16","16","15","1","10","3.56"
"110331","16","16","16","0","11","3.56"
"110796","13","13","13","0","11","3.56"
"110867","15","15","15","0","9","3.56"
"110969","21","21","20","1","16","3.56"
"111225","20","20","18","2","14","3.56"
"111233","13","13","13","0","9","3.56"
"111482","15","15","14","1","10","3.56"
"111792","17","17","16","1","13","3.56"
"111893","11","11","10","1","9","3.56"
"112115","12","12","12","0","9","3.56"
"112316","15","15","14","1","9","3.56"
"112611","11","11","9","2","9","3.56"
"113244","12","12","10","2","7","3.56"
"113508","15","15","14","1","9","3.56"
"113547","15","15","14","1","9","3.56"
"113652","12","12","11","1","10","3.56"
"113685","11","11","11","0","8","3.56"
"113869","14","13","13","1","12","3.56"
"114045","14","14","13","1","11","3.56"
"114065","15","15","12","3","8","3.56"
"114371","17","16","17","0","14","3.56"
"114435","10","10","9","1","8","3.56"
"114748","17","17","15","2","10","3.56"
"114811","17","17","16","1","9","3.56"
"114867","11","11","10","1","9","3.56"
"114988","16","16","14","2","10","3.56"
"115240","19","19","18","1","10","3.56"
"115292","12","12","8","4","6","3.56"
"115586","13","13","13","0","10","3.56"
"115593","11","11","9","2","8","3.56"
"115628","15","15","14","1","9","3.56"
"115634","18","18","17","1","10","3.56"
"116063","11","11","11","0","8","3.56"
"116082","15","15","14","1","8","3.56"
"116154","14","14","12","2","10","3.56"
"116202","16","16","14","2","11","3.56"
"116270","16","16","14","2","9","3.56"
"116345","17","17","17","0","13","3.56"
"116404","16","16","13","3","11","3.56"
"116413","17","17","15","2","10","3.56"
"116946","15","15","15","0","12","3.56"
"117169","16","16","14","2","12","3.56"
"117355","16","16","15","1","9","3.56"
"117560","13","13","13","0","9","3.56"
"100569","12","12","11","1","8","3.55"
"101254","23","23","22","1","13","3.55"
"101750","14","14","14","0","11","3.55"
"102539","20","20","16","4","10","3.55"
"104965","16","15","16","0","12","3.55"
"105258","17","16","12","5","11","3.55"
"105332","15","15","14","1","12","3.55"
"106206","22","22","20","2","16","3.55"
"106448","21","21","18","3","13","3.55"
"107812","20","20","18","2","13","3.55"
"107983","19","19","15","4","11","3.55"
"109874","11","11","10","1","7","3.55"
"110917","18","18","16","2","10","3.55"
"111810","20","20","19","1","14","3.55"
"113277","14","14","13","1","10","3.55"
"114255","23","23","22","1","18","3.55"
"115698","17","17","14","3","10","3.55"
"115902","12","12","10","2","8","3.55"
"117420","15","15","13","2","12","3.55"
"117577","18","18","14","4","12","3.55"
"100072","17","17","16","1","8","3.54"
"100101","11","11","10","1","7","3.54"
"100923","16","16","15","1","12","3.54"
"102014","12","12","11","1","9","3.54"
"102363","13","13","11","2","7","3.54"
"102636","19","19","19","0","13","3.54"
"102822","14","14","13","1","9","3.54"
"102841","23","23","21","2","17","3.54"
"103148","10","10","10","0","7","3.54"
"103903","19","19","16","3","8","3.54"
"104653","19","19","15","4","10","3.54"
"104832","15","15","12","3","10","3.54"
"104879","13","13","11","2","9","3.54"
"105403","9","9","9","0","8","3.54"
"105791","16","16","14","2","12","3.54"
"106878","14","14","14","0","12","3.54"
"107290","22","22","20","2","12","3.54"
"107666","16","16","13","3","12","3.54"
"107894","18","18","17","1","11","3.54"
"107977","16","16","14","2","11","3.54"
"108170","13","13","11","2","7","3.54"
"108522","14","14","12","2","9","3.54"
"108965","22","22","19","3","13","3.54"
"109092","19","19","15","4","14","3.54"
"109541","15","15","15","0","11","3.54"
"110169","18","18","18","0","7","3.54"
"110224","17","17","15","2","10","3.54"
"110671","12","12","11","1","9","3.54"
"111314","15","15","14","1","9","3.54"
"111383","15","15","12","3","11","3.54"
"112050","15","15","15","0","12","3.54"
"112590","13","13","13","0","11","3.54"
"112878","17","17","17","0","15","3.54"
"112949","16","16","15","1","14","3.54"
"113198","21","21","19","2","13","3.54"
"113216","15","15","14","1","11","3.54"
"113533","18","18","16","2","13","3.54"
"114123","16","16","15","1","10","3.54"
"114631","17","17","15","2","11","3.54"
"114717","15","15","13","2","12","3.54"
"114728","21","21","20","1","13","3.54"
"114778","17","17","16","1","13","3.54"
"115358","19","19","17","2","12","3.54"
"115796","18","18","15","3","11","3.54"
"115838","13","13","13","0","12","3.54"
"116382","18","18","16","2","11","3.54"
"116617","22","22","21","1","11","3.54"
"116813","18","18","16","2","13","3.54"
"116896","11","11","11","0","10","3.54"
"116930","10","10","8","2","7","3.54"
"117084","17","17","14","3","9","3.54"
"100168","19","19","17","2","12","3.53"
"100223","19","19","17","2","11","3.53"
"100249","15","15","13","2","11","3.53"
"100473","10","10","9","1","7","3.53"
"100691","13","13","11","2","7","3.53"
"100759","15","15","11","4","7","3.53"
"100889","18","18","17","1","11","3.53"
"101093","11","11","10","1","8","3.53"
"101313","12","12","11","1","7","3.53"
"101642","16","16","15","1","14","3.53"
"101730","15","15","14","1","10","3.53"
"101921","11","11","10","1","7","3.53"
"102255","14","14","13","1","12","3.53"
"102331","13","13","13","0","7","3.53"
"102630","9","9","9","0","7","3.53"
"103419","11","11","11","0","9","3.53"
"103603","13","13","13","0","9","3.53"
"103888","9","9","8","1","7","3.53"
"104145","11","11","10","1","9","3.53"
"104262","10","10","9","1","8","3.53"
"104498","14","14","11","3","8","3.53"
"104561","10","10","10","0","8","3.53"
"104896","16","16","14","2","12","3.53"
"105340","16","16","16","0","11","3.53"
"105501","12","12","11","1","7","3.53"
"105637","15","15","14","1","10","3.53"
"105823","19","19","19","0","12","3.53"
"105912","19","19","15","4","10","3.53"
"106259","17","17","16","1","12","3.53"
"106478","19","19","16","3","9","3.53"
"106734","15","15","13","2","7","3.53"
"107069","13","12","12","1","10","3.53"
"107590","18","18","16","2","9","3.53"
"107823","21","21","19","2","16","3.53"
"108016","23","23","20","3","18","3.53"
"108339","18","18","15","3","12","3.53"
"108697","12","12","12","0","10","3.53"
"108824","18","18","15","3","9","3.53"
"109124","21","21","21","0","11","3.53"
"109268","14","14","14","0","9","3.53"
"109381","10","10","10","0","7","3.53"
"109405","14","14","13","1","9","3.53"
"110697","15","15","14","1","10","3.53"
"110775","18","18","16","2","14","3.53"
"110779","23","23","21","2","14","3.53"
"110837","15","15","11","4","7","3.53"
"110973","19","19","18","1","11","3.53"
"111185","10","10","10","0","8","3.53"
"111493","14","14","12","2","9","3.53"
"111776","19","19","18","1","14","3.53"
"112258","15","15","13","2","10","3.53"
"112653","16","16","14","2","9","3.53"
"112850","16","16","16","0","12","3.53"
"113247","17","17","16","1","10","3.53"
"113308","15","15","14","1","12","3.53"
"113691","14","14","14","0","9","3.53"
"113766","20","20","18","2","11","3.53"
"113867","20","20","19","1","18","3.53"
"114514","19","19","17","2","10","3.53"
"114990","15","15","12","3","8","3.53"
"115270","13","12","13","0","9","3.53"
"115391","13","13","12","1","10","3.53"
"115644","12","12","12","0","8","3.53"
"115670","11","11","10","1","7","3.53"
"117312","8","8","8","0","7","3.53"
"117346","15","15","12","3","9","3.53"
"117454","12","12","12","0","10","3.53"
"100204","17","17","16","1","11","3.52"
"100887","17","17","16","1","13","3.52"
"101265","16","16","14","2","11","3.52"
"102323","13","13","12","1","10","3.52"
"103197","21","21","21","0","16","3.52"
"103292","19","19","19","0","15","3.52"
"103357","20","20","18","2","13","3.52"
"103759","12","12","11","1","10","3.52"
"104526","21","21","20","1","17","3.52"
"105798","19","18","16","3","11","3.52"
"106056","14","14","14","0","12","3.52"
"106487","17","17","16","1","11","3.52"
"107795","16","16","16","0","12","3.52"
"108164","21","21","18","3","13","3.52"
"108683","16","16","14","2","10","3.52"
"109337","23","23","20","3","15","3.52"
"109576","13","13","13","0","9","3.52"
"109605","22","22","18","4","14","3.52"
"109634","15","15","15","0","14","3.52"
"110831","19","19","15","4","10","3.52"
"111940","18","18","13","5","9","3.52"
"112071","12","12","10","2","10","3.52"
"112793","22","22","18","4","12","3.52"
"112957","13","13","13","0","12","3.52"
"113184","16","16","15","1","10","3.52"
"113292","21","20","20","1","14","3.52"
"113370","15","15","14","1","9","3.52"
"114268","15","15","13","2","9","3.52"
"115006","12","12","11","1","11","3.52"
"115032","17","17","15","2","12","3.52"
"115378","20","20","18","2","13","3.52"
"115404","17","17","14","3","9","3.52"
"117475","15","15","14","1","14","3.52"
"100731","15","15","14","1","12","3.51"
"105420","18","18","17","1","14","3.51"
"109883","20","20","19","1","15","3.51"
"112031","19","19","17","2","13","3.51"
"114509","24","24","20","4","15","3.51"
"116469","18","18","17","1","14","3.51"
"100013","16","16","15","1","6","3.50"
"100023","8","8","8","0","5","3.50"
"100061","12","12","9","3","6","3.50"
"100096","22","21","20","2","13","3.50"
"100116","14","14","11","3","7","3.50"
"100127","12","12","12","0","8","3.50"
"100167","15","15","15","0","10","3.50"
"100207","17","17","17","0","11","3.50"
"100215","12","12","10","2","7","3.50"
"100218","19","18","18","1","12","3.50"
"100225","10","10","9","1","7","3.50"
"100281","15","15","14","1","8","3.50"
"100314","11","11","11","0","7","3.50"
"100418","10","10","9","1","5","3.50"
"100474","15","15","14","1","10","3.50"
"100499","14","14","14","0","11","3.50"
"100503","12","12","11","1","8","3.50"
"100570","7","7","6","1","4","3.50"
"100625","11","11","9","2","6","3.50"
"100662","7","7","5","2","4","3.50"
"100670","12","12","11","1","8","3.50"
"100805","12","12","8","4","7","3.50"
"100809","13","13","11","2","8","3.50"
"100843","12","12","12","0","6","3.50"
"100876","16","16","16","0","12","3.50"
"100894","14","14","11","3","6","3.50"
"100947","18","18","16","2","8","3.50"
"100963","14","14","12","2","7","3.50"
"100978","13","13","12","1","8","3.50"
"101097","13","13","12","1","6","3.50"
"101208","10","10","10","0","8","3.50"
"101221","16","16","16","0","10","3.50"
"101271","11","11","11","0","6","3.50"
"101285","11","11","11","0","10","3.50"
"101286","17","17","15","2","8","3.50"
"101306","12","12","11","1","7","3.50"
"101391","9","9","8","1","6","3.50"
"101398","5","5","4","1","4","3.50"
"101419","10","10","9","1","4","3.50"
"101451","10","10","10","0","10","3.50"
"101468","18","18","14","4","9","3.50"
"101489","8","8","7","1","3","3.50"
"101500","12","12","12","0","9","3.50"
"101537","12","12","11","1","6","3.50"
"101554","15","15","15","0","10","3.50"
"101562","27","27","24","3","15","3.50"
"101637","4","4","3","1","2","3.50"
"101704","21","21","17","4","11","3.50"
"101713","18","18","16","2","9","3.50"
"101779","17","17","17","0","6","3.50"
"101852","16","16","14","2","9","3.50"
"101856","12","12","12","0","7","3.50"
"101888","10","10","10","0","7","3.50"
"101894","3","3","3","0","3","3.50"
"101907","3","3","2","1","2","3.50"
"101985","9","9","9","0","5","3.50"
"101995","11","11","10","1","8","3.50"
"102022","9","9","8","1","7","3.50"
"102036","10","10","9","1","4","3.50"
"102050","22","22","22","0","10","3.50"
"102065","13","13","10","3","8","3.50"
"102072","13","13","12","1","6","3.50"
"102154","19","19","17","2","8","3.50"
"102205","13","13","12","1","8","3.50"
"102245","8","8","5","3","2","3.50"
"102254","15","15","13","2","9","3.50"
"102311","11","11","10","1","8","3.50"
"102397","12","12","12","0","10","3.50"
"102398","15","15","12","3","7","3.50"
"102429","18","18","15","3","12","3.50"
"102517","22","22","21","1","16","3.50"
"102546","14","14","14","0","12","3.50"
"102582","7","7","6","1","5","3.50"
"102617","13","13","13","0","9","3.50"
"102624","13","13","11","2","6","3.50"
"102661","12","12","9","3","4","3.50"
"102672","7","7","6","1","4","3.50"
"102674","8","8","7","1","5","3.50"
"102693","15","15","14","1","6","3.50"
"102725","22","22","20","2","13","3.50"
"102758","23","23","23","0","15","3.50"
"102799","11","11","7","4","4","3.50"
"102889","8","8","7","1","4","3.50"
"102946","14","14","13","1","9","3.50"
"103002","15","15","12","3","7","3.50"
"103018","13","13","11","2","6","3.50"
"103052","5","5","5","0","4","3.50"
"103074","15","15","13","2","9","3.50"
"103097","17","17","15","2","10","3.50"
"103112","17","17","17","0","9","3.50"
"103226","9","9","9","0","6","3.50"
"103233","10","10","8","2","4","3.50"
"103250","9","8","7","2","4","3.50"
"103262","9","9","8","1","6","3.50"
"103297","17","17","15","2","9","3.50"
"103314","15","15","15","0","9","3.50"
"103360","16","16","15","1","7","3.50"
"103381","13","13","12","1","5","3.50"
"103434","17","17","15","2","6","3.50"
"103459","13","13","10","3","4","3.50"
"103554","8","8","8","0","7","3.50"
"103593","13","13","11","2","6","3.50"
"103685","12","12","10","2","7","3.50"
"103720","7","7","5","2","4","3.50"
"103721","13","13","11","2","9","3.50"
"103744","10","10","10","0","7","3.50"
"103774","11","11","10","1","6","3.50"
"103896","11","11","8","3","7","3.50"
"103932","10","10","10","0","6","3.50"
"103971","14","14","13","1","8","3.50"
"104016","12","12","12","0","7","3.50"
"104026","12","12","12","0","7","3.50"
"104035","8","8","7","1","4","3.50"
"104065","14","14","13","1","7","3.50"
"104103","14","14","12","2","8","3.50"
"104168","12","12","11","1","7","3.50"
"104173","14","14","14","0","7","3.50"
"104215","12","12","10","2","7","3.50"
"104221","12","12","11","1","10","3.50"
"104224","12","12","11","1","8","3.50"
"104227","10","10","9","1","5","3.50"
"104228","10","10","10","0","6","3.50"
"104235","16","16","14","2","13","3.50"
"104261","15","15","15","0","10","3.50"
"104330","13","13","12","1","8","3.50"
"104464","4","4","4","0","4","3.50"
"104519","12","12","11","1","6","3.50"
"104541","8","8","6","2","3","3.50"
"104552","10","10","10","0","7","3.50"
"104559","10","10","10","0","10","3.50"
"104562","12","12","12","0","4","3.50"
"104629","9","9","8","1","6","3.50"
"104702","16","16","16","0","10","3.50"
"104752","14","14","13","1","9","3.50"
"104766","16","16","16","0","9","3.50"
"104770","10","10","7","3","4","3.50"
"104797","15","15","15","0","12","3.50"
"104888","12","12","7","5","4","3.50"
"104944","4","4","4","0","3","3.50"
"104984","13","13","11","2","6","3.50"
"105017","14","14","12","2","7","3.50"
"105055","10","10","8","2","6","3.50"
"105062","16","16","13","3","9","3.50"
"105106","18","18","15","3","12","3.50"
"105157","14","14","13","1","8","3.50"
"105164","20","20","16","4","11","3.50"
"105172","17","17","16","1","11","3.50"
"105225","11","11","11","0","9","3.50"
"105228","12","12","11","1","8","3.50"
"105252","16","16","16","0","13","3.50"
"105273","8","8","7","1","5","3.50"
"105409","11","11","10","1","9","3.50"
"105425","7","7","7","0","5","3.50"
"105434","12","12","11","1","4","3.50"
"105439","17","17","15","2","9","3.50"
"105457","15","15","15","0","10","3.50"
"105460","16","16","12","4","7","3.50"
"105515","14","14","11","3","5","3.50"
"105527","8","8","7","1","5","3.50"
"105530","14","14","10","4","7","3.50"
"105548","20","20","18","2","11","3.50"
"105580","12","12","12","0","9","3.50"
"105599","14","14","12","2","10","3.50"
"105620","14","14","13","1","9","3.50"
"105827","22","22","22","0","12","3.50"
"105837","14","14","12","2","7","3.50"
"105852","6","6","4","2","3","3.50"
"105903","8","8","5","3","4","3.50"
"105925","16","16","15","1","11","3.50"
"105931","13","13","11","2","11","3.50"
"105961","12","12","10","2","4","3.50"
"105963","11","11","8","3","8","3.50"
"106069","16","16","14","2","10","3.50"
"106087","14","14","13","1","8","3.50"
"106124","14","14","12","2","10","3.50"
"106150","12","12","11","1","8","3.50"
"106167","11","11","9","2","7","3.50"
"106184","17","17","16","1","9","3.50"
"106279","11","11","10","1","7","3.50"
"106281","11","11","10","1","6","3.50"
"106289","19","19","19","0","11","3.50"
"106297","9","9","5","4","4","3.50"
"106304","11","11","10","1","7","3.50"
"106329","9","9","8","1","4","3.50"
"106379","12","12","10","2","5","3.50"
"106452","13","13","12","1","6","3.50"
"106461","10","10","10","0","5","3.50"
"106519","8","8","6","2","6","3.50"
"106593","12","12","11","1","6","3.50"
"106680","12","12","10","2","7","3.50"
"106727","17","17","14","3","9","3.50"
"106747","14","14","13","1","7","3.50"
"106819","9","9","8","1","4","3.50"
"106824","10","10","9","1","7","3.50"
"106838","13","13","12","1","8","3.50"
"106845","11","11","9","2","5","3.50"
"106883","14","14","14","0","13","3.50"
"106888","19","19","18","1","13","3.50"
"106889","8","8","5","3","4","3.50"
"106909","21","21","20","1","11","3.50"
"106926","13","13","13","0","9","3.50"
"106969","11","11","11","0","6","3.50"
"106977","14","14","12","2","6","3.50"
"107005","9","9","7","2","6","3.50"
"107010","18","18","15","3","12","3.50"
"107023","7","7","5","2","4","3.50"
"107073","12","12","7","5","7","3.50"
"107094","7","7","6","1","5","3.50"
"107213","19","19","18","1","10","3.50"
"107242","21","21","21","0","13","3.50"
"107252","10","10","9","1","8","3.50"
"107293","15","15","12","3","6","3.50"
"107325","13","13","12","1","9","3.50"
"107359","9","9","8","1","5","3.50"
"107386","14","14","12","2","8","3.50"
"107403","19","19","16","3","12","3.50"
"107405","17","17","16","1","14","3.50"
"107429","15","15","11","4","7","3.50"
"107499","10","10","9","1","5","3.50"
"107522","16","15","13","3","9","3.50"
"107553","18","18","18","0","12","3.50"
"107557","12","12","12","0","8","3.50"
"107561","20","20","18","2","12","3.50"
"107597","9","9","8","1","4","3.50"
"107614","11","11","10","1","7","3.50"
"107621","11","11","10","1","8","3.50"
"107737","15","15","13","2","8","3.50"
"107771","11","11","9","2","4","3.50"
"107787","11","11","10","1","7","3.50"
"107820","15","15","14","1","10","3.50"
"107847","8","8","8","0","7","3.50"
"107854","18","18","13","5","7","3.50"
"107868","16","16","13","3","7","3.50"
"107895","13","13","12","1","6","3.50"
"107925","15","15","14","1","10","3.50"
"107958","11","11","10","1","8","3.50"
"107964","7","7","7","0","4","3.50"
"107975","15","15","13","2","6","3.50"
"108012","14","14","12","2","11","3.50"
"108042","17","17","14","3","10","3.50"
"108047","13","13","11","2","9","3.50"
"108051","9","9","9","0","8","3.50"
"108112","13","13","11","2","7","3.50"
"108144","16","16","13","3","10","3.50"
"108274","9","9","9","0","5","3.50"
"108278","14","14","13","1","6","3.50"
"108301","11","11","11","0","7","3.50"
"108341","13","13","13","0","7","3.50"
"108366","14","14","14","0","10","3.50"
"108425","13","13","11","2","9","3.50"
"108434","12","12","11","1","6","3.50"
"108442","9","9","8","1","6","3.50"
"108478","14","14","13","1","12","3.50"
"108503","12","12","9","3","8","3.50"
"108506","16","16","16","0","10","3.50"
"108686","14","14","12","2","9","3.50"
"108717","12","12","12","0","10","3.50"
"108737","15","15","14","1","9","3.50"
"108775","10","10","9","1","7","3.50"
"108800","10","10","9","1","7","3.50"
"108835","14","14","14","0","8","3.50"
"108839","18","18","16","2","12","3.50"
"108868","10","10","8","2","7","3.50"
"108875","17","17","13","4","10","3.50"
"108896","9","9","8","1","4","3.50"
"108902","9","9","9","0","3","3.50"
"108941","15","15","15","0","9","3.50"
"109000","11","11","11","0","8","3.50"
"109029","15","15","12","3","4","3.50"
"109064","6","6","5","1","4","3.50"
"109079","14","14","13","1","5","3.50"
"109086","13","13","12","1","8","3.50"
"109137","5","5","5","0","4","3.50"
"109152","11","11","9","2","5","3.50"
"109207","11","11","9","2","7","3.50"
"109234","13","13","9","4","9","3.50"
"109249","20","20","18","2","10","3.50"
"109277","9","9","8","1","5","3.50"
"109325","13","13","9","4","8","3.50"
"109336","12","12","12","0","6","3.50"
"109358","15","15","14","1","9","3.50"
"109399","11","11","10","1","7","3.50"
"109431","16","16","12","4","10","3.50"
"109470","20","20","19","1","14","3.50"
"109480","13","12","13","0","8","3.50"
"109484","16","16","13","3","10","3.50"
"109494","7","7","6","1","5","3.50"
"109538","9","9","7","2","7","3.50"
"109545","15","15","14","1","10","3.50"
"109575","14","14","11","3","8","3.50"
"109612","11","11","10","1","5","3.50"
"109664","11","11","10","1","7","3.50"
"109667","14","14","10","4","7","3.50"
"109688","14","14","12","2","4","3.50"
"109741","15","15","12","3","8","3.50"
"109828","10","10","9","1","6","3.50"
"109880","11","11","9","2","8","3.50"
"109903","15","15","11","4","9","3.50"
"109917","11","11","9","2","6","3.50"
"109922","16","16","16","0","9","3.50"
"109945","10","10","9","1","7","3.50"
"109960","17","17","17","0","16","3.50"
"109968","9","9","8","1","6","3.50"
"110012","15","15","13","2","10","3.50"
"110025","12","12","10","2","9","3.50"
"110089","14","14","14","0","10","3.50"
"110098","12","12","11","1","7","3.50"
"110126","8","8","8","0","6","3.50"
"110127","14","14","13","1","7","3.50"
"110220","18","18","16","2","12","3.50"
"110247","13","13","13","0","8","3.50"
"110248","18","18","17","1","6","3.50"
"110279","11","11","8","3","6","3.50"
"110291","16","16","14","2","10","3.50"
"110295","11","11","9","2","7","3.50"
"110333","13","13","12","1","8","3.50"
"110354","15","15","12","3","8","3.50"
"110465","16","16","15","1","11","3.50"
"110538","9","9","8","1","4","3.50"
"110601","11","11","10","1","4","3.50"
"110637","17","17","16","1","12","3.50"
"110661","21","21","19","2","11","3.50"
"110674","15","15","14","1","9","3.50"
"110691","13","13","12","1","7","3.50"
"110713","15","14","14","1","11","3.50"
"110899","12","12","11","1","9","3.50"
"110932","21","21","19","2","11","3.50"
"111001","20","20","18","2","11","3.50"
"111092","13","13","11","2","10","3.50"
"111119","10","10","10","0","5","3.50"
"111167","14","14","13","1","8","3.50"
"111168","20","20","17","3","14","3.50"
"111172","11","11","10","1","4","3.50"
"111193","10","10","8","2","4","3.50"
"111206","14","14","11","3","9","3.50"
"111250","16","16","15","1","11","3.50"
"111267","12","12","11","1","6","3.50"
"111307","15","15","12","3","7","3.50"
"111401","21","21","15","6","11","3.50"
"111422","9","9","9","0","5","3.50"
"111462","10","10","9","1","7","3.50"
"111472","16","16","15","1","13","3.50"
"111509","14","14","11","3","7","3.50"
"111515","13","13","12","1","8","3.50"
"111518","8","8","7","1","4","3.50"
"111536","6","6","5","1","5","3.50"
"111542","10","10","8","2","5","3.50"
"111612","12","12","11","1","6","3.50"
"111646","11","11","10","1","6","3.50"
"111673","11","11","10","1","8","3.50"
"111676","14","14","12","2","8","3.50"
"111738","10","10","9","1","6","3.50"
"111787","15","15","11","4","10","3.50"
"111841","6","6","5","1","4","3.50"
"111917","15","15","14","1","10","3.50"
"111955","18","18","15","3","12","3.50"
"112006","10","10","9","1","5","3.50"
"112016","11","11","8","3","6","3.50"
"112021","17","17","15","2","9","3.50"
"112022","7","7","5","2","4","3.50"
"112067","12","12","9","3","4","3.50"
"112136","10","10","8","2","5","3.50"
"112140","10","10","10","0","5","3.50"
"112174","9","9","9","0","7","3.50"
"112177","16","16","13","3","6","3.50"
"112221","11","11","9","2","4","3.50"
"112268","12","12","10","2","5","3.50"
"112271","16","16","14","2","8","3.50"
"112303","12","12","11","1","6","3.50"
"112304","9","9","9","0","8","3.50"
"112321","14","14","10","4","6","3.50"
"112349","13","13","12","1","5","3.50"
"112404","11","11","11","0","7","3.50"
"112433","17","17","17","0","12","3.50"
"112437","12","12","11","1","10","3.50"
"112504","12","12","11","1","6","3.50"
"112522","17","17","15","2","9","3.50"
"112533","18","18","14","4","13","3.50"
"112541","8","8","8","0","6","3.50"
"112549","15","15","15","0","10","3.50"
"112591","12","12","12","0","8","3.50"
"112609","12","12","12","0","6","3.50"
"112623","7","7","7","0","5","3.50"
"112630","11","11","10","1","9","3.50"
"112652","5","5","5","0","5","3.50"
"112666","11","11","10","1","9","3.50"
"112667","11","11","10","1","8","3.50"
"112677","21","21","20","1","13","3.50"
"112702","10","9","10","0","6","3.50"
"112726","12","12","8","4","6","3.50"
"112731","18","18","13","5","13","3.50"
"112761","13","13","11","2","8","3.50"
"112784","10","10","9","1","9","3.50"
"112812","18","18","17","1","12","3.50"
"112831","9","9","8","1","7","3.50"
"112847","13","13","12","1","7","3.50"
"112848","21","21","18","3","13","3.50"
"112908","8","8","7","1","5","3.50"
"112919","6","6","6","0","4","3.50"
"112932","15","15","11","4","7","3.50"
"112989","15","15","11","4","7","3.50"
"112993","13","13","12","1","10","3.50"
"113066","10","10","9","1","6","3.50"
"113151","9","9","6","3","3","3.50"
"113169","12","12","11","1","8","3.50"
"113179","13","13","11","2","10","3.50"
"113199","10","10","8","2","4","3.50"
"113206","11","11","9","2","5","3.50"
"113257","10","10","8","2","4","3.50"
"113326","13","13","13","0","6","3.50"
"113334","10","10","10","0","7","3.50"
"113335","13","13","12","1","8","3.50"
"113373","16","16","15","1","12","3.50"
"113407","19","19","18","1","12","3.50"
"113417","15","15","14","1","9","3.50"
"113433","9","9","8","1","6","3.50"
"113438","19","19","17","2","11","3.50"
"113447","15","15","14","1","9","3.50"
"113483","16","16","13","3","9","3.50"
"113574","15","15","11","4","9","3.50"
"113583","13","13","11","2","5","3.50"
"113619","7","7","6","1","2","3.50"
"113638","14","14","12","2","6","3.50"
"113648","17","17","16","1","8","3.50"
"113774","12","12","10","2","6","3.50"
"113807","9","9","8","1","6","3.50"
"113808","13","13","12","1","6","3.50"
"113818","12","12","10","2","8","3.50"
"113864","10","10","10","0","6","3.50"
"113913","10","10","10","0","8","3.50"
"113915","13","13","13","0","7","3.50"
"113942","16","16","15","1","10","3.50"
"114017","13","13","12","1","9","3.50"
"114027","9","9","7","2","6","3.50"
"114035","8","8","8","0","5","3.50"
"114044","19","19","16","3","10","3.50"
"114119","9","9","8","1","6","3.50"
"114151","9","9","9","0","4","3.50"
"114222","11","11","10","1","7","3.50"
"114245","19","19","19","0","15","3.50"
"114276","9","9","9","0","4","3.50"
"114290","12","12","12","0","8","3.50"
"114305","10","10","10","0","9","3.50"
"114339","11","11","10","1","8","3.50"
"114349","8","8","8","0","5","3.50"
"114408","15","15","14","1","10","3.50"
"114429","10","10","9","1","7","3.50"
"114432","16","16","14","2","7","3.50"
"114488","7","7","6","1","4","3.50"
"114539","12","12","12","0","8","3.50"
"114584","10","10","10","0","5","3.50"
"114630","7","7","6","1","6","3.50"
"114643","8","8","8","0","8","3.50"
"114680","11","11","9","2","6","3.50"
"114764","5","5","5","0","4","3.50"
"114807","9","9","6","3","4","3.50"
"114900","14","14","14","0","12","3.50"
"114946","15","15","12","3","8","3.50"
"115010","11","11","11","0","6","3.50"
"115116","11","11","10","1","4","3.50"
"115128","13","13","11","2","7","3.50"
"115175","9","9","9","0","4","3.50"
"115198","12","11","10","2","7","3.50"
"115230","20","20","19","1","9","3.50"
"115248","7","6","7","0","6","3.50"
"115287","12","12","11","1","8","3.50"
"115307","14","14","12","2","7","3.50"
"115350","4","4","4","0","4","3.50"
"115353","13","13","12","1","10","3.50"
"115377","11","11","9","2","7","3.50"
"115379","16","16","15","1","14","3.50"
"115481","13","13","13","0","8","3.50"
"115536","14","14","11","3","6","3.50"
"115567","15","15","15","0","10","3.50"
"115582","7","7","6","1","4","3.50"
"115617","14","14","11","3","4","3.50"
"115639","16","16","14","2","10","3.50"
"115684","13","13","10","3","5","3.50"
"115723","17","17","14","3","8","3.50"
"115777","16","16","15","1","11","3.50"
"115794","20","20","18","2","12","3.50"
"115799","16","16","14","2","9","3.50"
"115849","18","18","18","0","12","3.50"
"115945","16","16","15","1","8","3.50"
"116052","12","12","11","1","6","3.50"
"116105","20","20","18","2","11","3.50"
"116133","7","7","7","0","6","3.50"
"116285","12","12","11","1","9","3.50"
"116369","13","13","11","2","7","3.50"
"116391","20","20","18","2","9","3.50"
"116420","13","13","12","1","11","3.50"
"116437","15","15","15","0","11","3.50"
"116484","12","12","11","1","6","3.50"
"116536","15","15","13","2","10","3.50"
"116581","14","14","14","0","13","3.50"
"116582","14","14","13","1","6","3.50"
"116633","16","16","15","1","8","3.50"
"116637","12","12","11","1","8","3.50"
"116645","15","15","14","1","8","3.50"
"116649","12","12","12","0","6","3.50"
"116709","15","15","13","2","12","3.50"
"116766","12","12","12","0","8","3.50"
"116778","11","11","11","0","7","3.50"
"116792","13","13","12","1","8","3.50"
"116816","15","15","11","4","8","3.50"
"116878","13","13","12","1","6","3.50"
"116882","13","13","11","2","7","3.50"
"116916","6","6","5","1","2","3.50"
"116931","11","11","9","2","5","3.50"
"116951","15","15","15","0","9","3.50"
"117020","9","9","9","0","8","3.50"
"117021","17","17","14","3","10","3.50"
"117058","16","16","13","3","10","3.50"
"117109","12","12","8","4","7","3.50"
"117113","19","19","18","1","14","3.50"
"117124","9","9","7","2","6","3.50"
"117127","7","7","5","2","4","3.50"
"117171","11","10","10","1","8","3.50"
"117188","15","15","14","1","10","3.50"
"117254","13","13","12","1","7","3.50"
"117267","9","9","7","2","4","3.50"
"117296","14","14","12","2","7","3.50"
"117303","10","10","10","0","7","3.50"
"117316","10","10","10","0","7","3.50"
"117325","13","13","11","2","5","3.50"
"117334","9","9","8","1","6","3.50"
"117415","12","12","8","4","5","3.50"
"117455","13","13","12","1","11","3.50"
"117570","13","13","11","2","6","3.50"
"117601","20","20","17","3","13","3.50"
"100089","19","19","16","3","13","3.49"
"100624","16","16","16","0","12","3.49"
"104538","18","18","18","0","16","3.49"
"105125","22","22","21","1","16","3.49"
"106060","18","18","15","3","12","3.49"
"107085","15","15","12","3","11","3.49"
"111269","17","17","16","1","13","3.49"
"111370","18","18","17","1","12","3.49"
"111372","16","16","16","0","13","3.49"
"111671","20","20","20","0","16","3.49"
"112052","19","19","16","3","12","3.49"
"113372","14","14","12","2","11","3.49"
"116733","14","14","13","1","11","3.49"
"100523","17","17","16","1","15","3.48"
"100997","15","15","14","1","9","3.48"
"101056","17","17","16","1","12","3.48"
"101061","15","15","13","2","12","3.48"
"101279","24","24","22","2","16","3.48"
"101320","13","13","13","0","11","3.48"
"102496","16","16","16","0","11","3.48"
"104463","20","20","17","3","14","3.48"
"104670","17","17","17","0","13","3.48"
"104874","24","24","24","0","19","3.48"
"105198","15","15","14","1","9","3.48"
"105418","14","14","12","2","9","3.48"
"106334","17","17","14","3","13","3.48"
"106567","18","18","18","0","13","3.48"
"106991","16","16","15","1","10","3.48"
"107266","18","18","16","2","12","3.48"
"108549","17","17","17","0","14","3.48"
"108701","23","23","20","3","15","3.48"
"109772","16","16","14","2","10","3.48"
"109831","14","14","13","1","10","3.48"
"110037","20","20","19","1","12","3.48"
"110118","19","19","16","3","12","3.48"
"110124","21","21","19","2","12","3.48"
"110304","21","21","20","1","15","3.48"
"110843","12","12","12","0","12","3.48"
"111583","20","20","19","1","14","3.48"
"112620","20","20","18","2","12","3.48"
"113175","15","15","14","1","9","3.48"
"113217","16","16","16","0","11","3.48"
"114056","17","17","14","3","11","3.48"
"114987","17","17","17","0","13","3.48"
"115188","16","16","14","2","12","3.48"
"115420","21","21","20","1","12","3.48"
"115837","15","15","14","1","13","3.48"
"117219","12","12","12","0","11","3.48"
"100197","17","17","15","2","12","3.47"
"100455","12","12","11","1","7","3.47"
"100559","18","18","15","3","10","3.47"
"100915","11","11","10","1","8","3.47"
"101131","16","16","13","3","10","3.47"
"101434","9","9","9","0","7","3.47"
"101612","14","14","11","3","7","3.47"
"101614","14","14","13","1","10","3.47"
"101945","21","21","15","6","12","3.47"
"102505","13","13","13","0","7","3.47"
"102737","23","23","21","2","17","3.47"
"102965","19","19","17","2","10","3.47"
"103939","14","14","13","1","11","3.47"
"104116","17","17","16","1","11","3.47"
"104543","13","13","12","1","9","3.47"
"105208","14","14","10","4","7","3.47"
"105496","16","16","15","1","11","3.47"
"105700","10","10","10","0","7","3.47"
"106133","16","16","13","3","9","3.47"
"106343","18","18","17","1","10","3.47"
"106426","17","17","15","2","9","3.47"
"106598","11","11","11","0","8","3.47"
"106677","13","13","13","0","9","3.47"
"106782","15","15","13","2","9","3.47"
"106852","23","23","22","1","16","3.47"
"107448","19","19","18","1","14","3.47"
"107682","19","19","17","2","12","3.47"
"107749","16","16","14","2","8","3.47"
"107784","17","17","14","3","13","3.47"
"107858","14","14","13","1","11","3.47"
"108343","14","14","14","0","11","3.47"
"109010","12","12","10","2","8","3.47"
"109039","16","16","14","2","10","3.47"
"109344","15","15","14","1","11","3.47"
"109920","14","14","13","1","11","3.47"
"109957","19","19","18","1","11","3.47"
"110131","10","10","8","2","8","3.47"
"110484","13","13","10","3","9","3.47"
"110533","16","16","14","2","8","3.47"
"110865","14","14","12","2","7","3.47"
"110906","20","20","18","2","14","3.47"
"111073","18","18","16","2","10","3.47"
"112182","19","19","17","2","12","3.47"
"112490","17","17","13","4","9","3.47"
"112574","16","16","15","1","10","3.47"
"112747","11","11","10","1","7","3.47"
"112879","15","15","13","2","7","3.47"
"112898","15","15","14","1","9","3.47"
"112964","18","18","14","4","8","3.47"
"113164","15","15","13","2","10","3.47"
"113241","14","14","11","3","9","3.47"
"113315","16","16","14","2","9","3.47"
"113394","17","17","15","2","9","3.47"
"114029","17","17","15","2","10","3.47"
"114611","18","18","18","0","11","3.47"
"114776","10","10","9","1","7","3.47"
"115130","11","11","10","1","7","3.47"
"115184","15","15","12","3","7","3.47"
"115599","13","13","12","1","9","3.47"
"115657","16","16","14","2","10","3.47"
"116156","19","19","15","4","12","3.47"
"116659","14","14","12","2","10","3.47"
"117063","18","18","18","0","14","3.47"
"100160","14","14","14","0","12","3.46"
"101411","17","17","16","1","14","3.46"
"102055","17","17","13","4","9","3.46"
"103251","15","15","13","2","10","3.46"
"103955","14","14","13","1","11","3.46"
"104220","18","18","16","2","11","3.46"
"104242","19","19","17","2","13","3.46"
"104664","12","12","12","0","11","3.46"
"104901","15","15","15","0","13","3.46"
"105098","17","17","17","0","11","3.46"
"105587","13","13","12","1","10","3.46"
"106955","15","15","14","1","10","3.46"
"107929","12","12","12","0","7","3.46"
"107940","18","18","17","1","11","3.46"
"108400","13","13","12","1","9","3.46"
"108635","15","15","13","2","10","3.46"
"110309","20","20","19","1","16","3.46"
"110480","17","17","14","3","12","3.46"
"110594","16","16","16","0","11","3.46"
"111004","14","14","14","0","12","3.46"
"111336","18","18","17","1","12","3.46"
"111385","19","19","17","2","13","3.46"
"111545","16","16","16","0","12","3.46"
"111760","15","15","12","3","7","3.46"
"113125","23","23","23","0","16","3.46"
"113789","19","19","17","2","11","3.46"
"113798","15","15","15","0","10","3.46"
"114854","17","17","15","2","13","3.46"
"115140","18","18","16","2","12","3.46"
"115220","17","17","15","2","11","3.46"
"115818","19","19","17","2","11","3.46"
"116587","17","17","16","1","14","3.46"
"116888","20","20","16","4","12","3.46"
"117190","13","13","11","2","9","3.46"
"100363","16","16","15","1","12","3.45"
"100441","16","16","12","4","10","3.45"
"100461","18","18","14","4","9","3.45"
"100800","12","12","11","1","8","3.45"
"100965","18","18","17","1","12","3.45"
"102194","15","15","14","1","13","3.45"
"102795","21","21","20","1","13","3.45"
"103086","15","15","14","1","9","3.45"
"103407","16","16","15","1","11","3.45"
"103461","24","24","23","1","14","3.45"
"103610","15","15","14","1","10","3.45"
"104067","14","14","13","1","11","3.45"
"104236","14","14","13","1","10","3.45"
"104811","14","14","13","1","11","3.45"
"105287","14","14","13","1","10","3.45"
"107024","13","13","11","2","8","3.45"
"107123","12","12","12","0","9","3.45"
"107455","17","17","17","0","11","3.45"
"107471","13","13","13","0","11","3.45"
"107576","10","10","9","1","9","3.45"
"107699","13","13","13","0","10","3.45"
"107783","21","21","20","1","14","3.45"
"108010","19","19","17","2","10","3.45"
"108092","20","20","15","5","12","3.45"
"108365","20","20","20","0","13","3.45"
"108387","14","14","14","0","10","3.45"
"109247","19","19","19","0","15","3.45"
"109670","17","17","15","2","10","3.45"
"110176","23","23","21","2","12","3.45"
"110611","12","12","12","0","9","3.45"
"110662","18","18","17","1","10","3.45"
"110799","9","8","8","1","8","3.45"
"110812","13","13","13","0","9","3.45"
"110908","16","16","16","0","10","3.45"
"111440","20","20","20","0","11","3.45"
"111500","21","21","21","0","13","3.45"
"112360","17","17","16","1","10","3.45"
"113342","18","18","14","4","9","3.45"
"114370","21","21","19","2","13","3.45"
"114433","11","11","9","2","8","3.45"
"114467","15","15","13","2","10","3.45"
"114561","14","14","13","1","11","3.45"
"115004","14","14","13","1","9","3.45"
"115169","18","18","17","1","12","3.45"
"115187","17","17","15","2","8","3.45"
"115247","15","15","15","0","11","3.45"
"115764","16","16","15","1","9","3.45"
"115872","11","11","10","1","8","3.45"
"115912","17","17","17","0","11","3.45"
"116922","17","17","15","2","9","3.45"
"117285","11","11","9","2","8","3.45"
"117547","13","13","13","0","10","3.45"
"100451","17","17","14","3","9","3.44"
"100544","16","16","14","2","9","3.44"
"100738","14","14","13","1","10","3.44"
"101160","13","13","13","0","9","3.44"
"101167","18","18","16","2","11","3.44"
"101368","16","16","14","2","11","3.44"
"101868","9","9","6","3","5","3.44"
"101934","20","20","18","2","13","3.44"
"102122","18","18","15","3","9","3.44"
"102175","11","11","11","0","9","3.44"
"102212","18","18","16","2","12","3.44"
"102476","19","19","15","4","11","3.44"
"103928","17","17","16","1","10","3.44"
"104093","13","13","13","0","8","3.44"
"105070","15","15","11","4","9","3.44"
"105171","17","17","15","2","11","3.44"
"105523","18","18","13","5","10","3.44"
"105541","17","17","16","1","11","3.44"
"105566","13","13","11","2","10","3.44"
"106104","19","19","17","2","12","3.44"
"106152","19","19","16","3","11","3.44"
"106216","13","13","11","2","8","3.44"
"106543","24","24","17","7","13","3.44"
"107153","15","15","15","0","11","3.44"
"107274","17","17","17","0","14","3.44"
"108671","15","15","15","0","11","3.44"
"109061","12","12","11","1","7","3.44"
"109184","16","16","14","2","5","3.44"
"109191","19","19","19","0","13","3.44"
"109492","18","18","13","5","9","3.44"
"109694","21","21","18","3","17","3.44"
"109781","9","9","8","1","6","3.44"
"110023","20","20","20","0","16","3.44"
"110432","22","22","19","3","13","3.44"
"111103","19","19","18","1","15","3.44"
"112172","16","15","15","1","11","3.44"
"112237","17","17","15","2","11","3.44"
"112289","16","16","16","0","11","3.44"
"113424","15","15","15","0","12","3.44"
"113612","11","11","11","0","9","3.44"
"113721","18","18","15","3","9","3.44"
"113935","19","19","14","5","11","3.44"
"114147","11","11","10","1","9","3.44"
"114176","11","11","11","0","5","3.44"
"114186","16","16","14","2","12","3.44"
"114189","20","20","18","2","11","3.44"
"114364","16","16","13","3","11","3.44"
"114627","14","14","13","1","10","3.44"
"114760","14","14","13","1","6","3.44"
"115052","12","12","10","2","8","3.44"
"115893","8","8","6","2","5","3.44"
"115906","18","18","17","1","11","3.44"
"116060","17","17","17","0","12","3.44"
"116911","19","19","15","4","9","3.44"
"117587","14","14","13","1","10","3.44"
"100002","16","16","16","0","12","3.43"
"100052","14","14","12","2","7","3.43"
"100177","10","10","10","0","9","3.43"
"100193","17","17","15","2","8","3.43"
"100262","14","14","14","0","12","3.43"
"100330","13","13","11","2","8","3.43"
"100546","18","18","16","2","11","3.43"
"100572","18","18","16","2","8","3.43"
"100591","15","15","13","2","8","3.43"
"100633","12","12","10","2","7","3.43"
"100726","20","20","17","3","11","3.43"
"101046","13","13","13","0","10","3.43"
"101165","14","14","13","1","8","3.43"
"101499","21","21","18","3","14","3.43"
"101824","19","19","16","3","11","3.43"
"101905","18","18","17","1","14","3.43"
"101975","17","17","17","0","11","3.43"
"102108","15","15","13","2","7","3.43"
"102203","13","13","11","2","9","3.43"
"102577","14","14","14","0","10","3.43"
"102871","16","16","14","2","8","3.43"
"102933","13","13","11","2","8","3.43"
"103222","14","14","10","4","8","3.43"
"103277","18","18","18","0","13","3.43"
"103302","15","15","14","1","12","3.43"
"103330","14","14","13","1","10","3.43"
"103418","11","10","11","0","10","3.43"
"103490","19","19","17","2","12","3.43"
"103609","14","14","13","1","10","3.43"
"103900","12","12","12","0","9","3.43"
"103935","15","15","15","0","9","3.43"
"105097","12","12","8","4","8","3.43"
"105397","15","15","14","1","11","3.43"
"105404","15","15","14","1","11","3.43"
"105563","21","21","18","3","10","3.43"
"105640","22","22","20","2","13","3.43"
"105894","12","12","12","0","8","3.43"
"105971","13","13","12","1","12","3.43"
"106223","20","20","20","0","16","3.43"
"106325","15","15","15","0","11","3.43"
"106439","12","12","12","0","7","3.43"
"106693","15","15","15","0","7","3.43"
"106807","18","18","14","4","9","3.43"
"106826","15","15","11","4","9","3.43"
"106910","11","11","9","2","7","3.43"
"107045","18","18","14","4","9","3.43"
"107168","16","15","16","0","14","3.43"
"107184","17","17","16","1","11","3.43"
"107225","14","14","12","2","11","3.43"
"107575","16","16","16","0","10","3.43"
"107662","14","14","13","1","9","3.43"
"107684","11","11","11","0","10","3.43"
"108174","19","19","15","4","14","3.43"
"108511","20","20","15","5","15","3.43"
"108576","8","8","7","1","7","3.43"
"108767","22","22","20","2","14","3.43"
"108907","15","15","14","1","10","3.43"
"109090","16","16","14","2","12","3.43"
"109307","13","13","13","0","11","3.43"
"109340","19","19","18","1","12","3.43"
"109636","18","18","16","2","12","3.43"
"109801","13","13","12","1","10","3.43"
"109884","10","10","10","0","9","3.43"
"109988","16","16","15","1","8","3.43"
"109995","17","17","13","4","9","3.43"
"110026","17","17","14","3","9","3.43"
"110034","17","17","15","2","10","3.43"
"110065","15","15","13","2","9","3.43"
"110121","15","15","13","2","11","3.43"
"110154","13","13","11","2","8","3.43"
"110313","20","20","17","3","14","3.43"
"110364","12","12","10","2","8","3.43"
"110486","21","21","16","5","10","3.43"
"110561","19","19","17","2","11","3.43"
"110708","14","14","13","1","11","3.43"
"110765","17","17","16","1","10","3.43"
"111326","15","15","15","0","12","3.43"
"111580","15","15","13","2","8","3.43"
"111834","13","13","12","1","9","3.43"
"112138","10","10","8","2","8","3.43"
"112205","21","21","21","0","14","3.43"
"112249","10","10","10","0","9","3.43"
"112562","11","11","9","2","8","3.43"
"112684","11","11","10","1","8","3.43"
"112751","19","19","19","0","13","3.43"
"112804","15","15","15","0","10","3.43"
"112828","13","13","12","1","7","3.43"
"112966","17","17","16","1","12","3.43"
"113176","13","13","12","1","10","3.43"
"113177","17","17","15","2","9","3.43"
"113360","15","15","14","1","9","3.43"
"113582","14","14","14","0","11","3.43"
"113609","14","14","12","2","8","3.43"
"113990","18","18","17","1","12","3.43"
"114094","8","8","8","0","8","3.43"
"114464","12","12","12","0","7","3.43"
"114595","14","14","13","1","10","3.43"
"114721","21","21","18","3","11","3.43"
"114863","15","15","11","4","7","3.43"
"114864","13","13","12","1","9","3.43"
"115277","12","12","11","1","8","3.43"
"115487","15","15","15","0","11","3.43"
"116114","11","11","11","0","8","3.43"
"116337","15","15","14","1","9","3.43"
"116433","14","14","12","2","10","3.43"
"116589","15","15","14","1","9","3.43"
"116875","13","13","11","2","9","3.43"
"117215","17","17","15","2","10","3.43"
"117277","13","13","13","0","10","3.43"
"117332","12","12","12","0","9","3.43"
"100020","11","11","11","0","7","3.42"
"100080","14","14","10","4","7","3.42"
"100357","13","13","10","3","7","3.42"
"100384","19","19","17","2","9","3.42"
"100414","12","12","12","0","11","3.42"
"100421","15","15","11","4","9","3.42"
"100454","22","22","19","3","13","3.42"
"100632","18","18","15","3","11","3.42"
"100643","12","12","11","1","9","3.42"
"100789","14","14","14","0","8","3.42"
"100830","14","14","14","0","10","3.42"
"100961","16","16","12","4","9","3.42"
"101038","14","14","13","1","7","3.42"
"101141","10","10","10","0","7","3.42"
"101159","12","12","12","0","9","3.42"
"101305","21","21","18","3","10","3.42"
"101526","18","18","16","2","10","3.42"
"101746","15","15","14","1","13","3.42"
"101891","14","14","14","0","13","3.42"
"102031","12","12","11","1","8","3.42"
"102195","14","14","12","2","8","3.42"
"102475","16","16","15","1","11","3.42"
"103243","13","13","10","3","9","3.42"
"103248","15","15","12","3","9","3.42"
"103494","15","15","12","3","8","3.42"
"103583","13","13","13","0","8","3.42"
"103876","16","16","13","3","8","3.42"
"104074","17","17","17","0","11","3.42"
"104115","18","18","16","2","10","3.42"
"104179","14","14","11","3","10","3.42"
"104418","15","15","12","3","10","3.42"
"104433","17","17","14","3","9","3.42"
"104478","8","8","8","0","7","3.42"
"104746","17","17","13","4","11","3.42"
"104842","18","18","16","2","12","3.42"
"105268","12","12","11","1","7","3.42"
"105291","23","23","18","5","15","3.42"
"105507","13","13","9","4","7","3.42"
"105532","11","11","10","1","7","3.42"
"105561","15","15","11","4","9","3.42"
"105593","14","14","13","1","9","3.42"
"105664","9","9","9","0","7","3.42"
"105914","16","16","14","2","11","3.42"
"106025","16","16","14","2","10","3.42"
"106110","18","18","15","3","10","3.42"
"106164","17","17","16","1","10","3.42"
"106377","11","11","9","2","7","3.42"
"106643","15","15","11","4","9","3.42"
"106716","18","18","16","2","14","3.42"
"106722","12","12","11","1","8","3.42"
"106941","10","10","7","3","7","3.42"
"107042","14","14","13","1","8","3.42"
"107068","12","12","12","0","12","3.42"
"107234","16","16","14","2","11","3.42"
"107270","19","19","15","4","10","3.42"
"107321","18","18","16","2","10","3.42"
"107335","16","16","13","3","9","3.42"
"107535","13","13","11","2","7","3.42"
"107778","12","12","12","0","8","3.42"
"108044","18","18","18","0","13","3.42"
"108062","14","14","10","4","8","3.42"
"108072","15","15","10","5","9","3.42"
"108118","12","12","10","2","7","3.42"
"108234","11","11","10","1","10","3.42"
"108860","12","12","10","2","6","3.42"
"108906","15","15","15","0","10","3.42"
"109109","12","12","10","2","7","3.42"
"109160","16","16","16","0","12","3.42"
"109369","13","13","12","1","8","3.42"
"109395","11","11","10","1","8","3.42"
"109439","9","9","8","1","7","3.42"
"109666","15","15","12","3","7","3.42"
"109715","10","10","10","0","7","3.42"
"109850","18","18","15","3","11","3.42"
"110111","12","12","12","0","9","3.42"
"110214","14","14","14","0","10","3.42"
"110370","13","13","11","2","8","3.42"
"110527","9","9","9","0","7","3.42"
"110684","21","21","21","0","14","3.42"
"110700","17","17","12","5","8","3.42"
"110718","13","13","12","1","9","3.42"
"111040","13","13","13","0","7","3.42"
"111059","17","17","16","1","11","3.42"
"111111","15","15","14","1","9","3.42"
"111212","11","11","11","0","7","3.42"
"111221","22","22","21","1","15","3.42"
"111292","14","14","12","2","8","3.42"
"111400","19","19","17","2","8","3.42"
"111513","19","17","18","1","13","3.42"
"111564","15","15","15","0","10","3.42"
"111669","15","15","15","0","9","3.42"
"111770","12","12","11","1","9","3.42"
"111786","17","17","15","2","9","3.42"
"111822","16","16","16","0","11","3.42"
"111933","15","15","14","1","8","3.42"
"111981","12","12","11","1","7","3.42"
"111998","12","12","12","0","8","3.42"
"112014","13","13","12","1","10","3.42"
"112145","13","13","11","2","8","3.42"
"112290","11","11","9","2","8","3.42"
"112431","15","15","14","1","9","3.42"
"112448","14","14","13","1","8","3.42"
"112542","15","15","13","2","8","3.42"
"112783","17","17","15","2","9","3.42"
"113098","14","14","12","2","8","3.42"
"113406","11","11","11","0","7","3.42"
"113463","18","18","17","1","15","3.42"
"113815","8","8","8","0","5","3.42"
"113825","10","10","9","1","7","3.42"
"113845","16","16","14","2","9","3.42"
"114022","16","16","13","3","7","3.42"
"114207","13","13","12","1","12","3.42"
"114236","10","10","8","2","8","3.42"
"114367","12","12","9","3","7","3.42"
"114427","23","23","22","1","15","3.42"
"114447","12","12","9","3","8","3.42"
"114453","14","14","14","0","7","3.42"
"114879","10","10","10","0","8","3.42"
"114935","14","14","12","2","11","3.42"
"114977","12","12","12","0","7","3.42"
"115037","20","20","18","2","8","3.42"
"115062","10","10","10","0","8","3.42"
"115078","13","13","11","2","9","3.42"
"115138","16","16","15","1","9","3.42"
"115181","11","11","10","1","6","3.42"
"115483","11","11","11","0","8","3.42"
"115526","11","11","10","1","8","3.42"
"115751","14","14","13","1","10","3.42"
"115806","12","12","11","1","8","3.42"
"115842","12","12","10","2","8","3.42"
"115889","12","12","12","0","7","3.42"
"116048","12","12","10","2","7","3.42"
"116123","8","8","8","0","7","3.42"
"116179","16","16","14","2","9","3.42"
"116339","10","10","8","2","7","3.42"
"116351","14","14","13","1","10","3.42"
"116564","16","16","16","0","9","3.42"
"116571","12","12","10","2","8","3.42"
"116949","15","15","12","3","9","3.42"
"117135","20","20","20","0","13","3.42"
"117148","10","10","10","0","8","3.42"
"117309","12","12","12","0","8","3.42"
"117328","15","15","13","2","7","3.42"
"117401","12","12","10","2","9","3.42"
"117573","16","16","13","3","7","3.42"
"117600","18","18","17","1","9","3.42"
"117621","13","13","10","3","7","3.42"
"103496","16","16","14","2","12","3.41"
"103537","21","21","21","0","12","3.41"
"105080","22","22","20","2","14","3.41"
"105835","16","16","14","2","11","3.41"
"107330","19","19","19","0","13","3.41"
"110056","21","21","21","0","13","3.41"
"112971","14","14","14","0","13","3.41"
"117388","18","18","16","2","13","3.41"
"117402","18","18","16","2","12","3.41"
"100067","14","14","12","2","6","3.40"
"100076","19","19","18","1","13","3.40"
"100115","10","10","9","1","5","3.40"
"100145","13","13","11","2","7","3.40"
"100217","14","14","14","0","11","3.40"
"100234","9","9","8","1","6","3.40"
"100276","13","13","10","3","7","3.40"
"100291","7","7","7","0","5","3.40"
"100518","13","13","13","0","10","3.40"
"100580","20","20","17","3","13","3.40"
"100584","12","12","10","2","6","3.40"
"100626","12","12","11","1","10","3.40"
"100659","11","11","9","2","5","3.40"
"100714","12","12","10","2","6","3.40"
"100734","15","15","11","4","6","3.40"
"100860","7","7","7","0","6","3.40"
"101047","16","16","13","3","11","3.40"
"101174","14","14","11","3","7","3.40"
"101348","11","11","7","4","5","3.40"
"101443","11","11","11","0","7","3.40"
"101517","13","13","11","2","6","3.40"
"101621","11","11","11","0","7","3.40"
"101630","6","6","6","0","5","3.40"
"101926","14","14","12","2","8","3.40"
"101948","11","11","9","2","7","3.40"
"102119","12","12","9","3","5","3.40"
"102147","12","12","10","2","5","3.40"
"102360","20","20","18","2","14","3.40"
"102435","19","19","17","2","9","3.40"
"102805","11","11","9","2","5","3.40"
"102956","9","9","7","2","5","3.40"
"102958","22","22","20","2","13","3.40"
"103107","7","7","5","2","5","3.40"
"103147","19","19","17","2","13","3.40"
"103333","12","12","10","2","7","3.40"
"103472","17","17","13","4","12","3.40"
"103540","14","14","13","1","7","3.40"
"103585","20","20","17","3","12","3.40"
"103810","13","13","13","0","7","3.40"
"103822","13","13","13","0","8","3.40"
"104057","17","17","15","2","11","3.40"
"104405","17","17","15","2","12","3.40"
"104680","14","14","11","3","6","3.40"
"104883","14","14","13","1","7","3.40"
"105087","15","15","13","2","5","3.40"
"105096","13","13","11","2","8","3.40"
"105272","14","14","14","0","7","3.40"
"105333","12","12","9","3","6","3.40"
"105572","13","13","11","2","6","3.40"
"105586","16","16","16","0","12","3.40"
"105630","13","13","9","4","5","3.40"
"105632","20","20","18","2","6","3.40"
"105763","9","9","7","2","5","3.40"
"105819","16","16","15","1","13","3.40"
"105992","16","16","16","0","11","3.40"
"106009","12","12","11","1","8","3.40"
"106274","16","16","15","1","7","3.40"
"106392","12","12","10","2","7","3.40"
"106511","16","16","16","0","9","3.40"
"106619","14","14","13","1","12","3.40"
"106621","12","12","12","0","10","3.40"
"106691","9","9","9","0","7","3.40"
"106737","16","16","15","1","11","3.40"
"107163","10","10","9","1","7","3.40"
"107392","13","13","12","1","7","3.40"
"107578","14","13","13","1","8","3.40"
"107679","8","8","8","0","8","3.40"
"107761","11","11","8","3","7","3.40"
"107846","12","12","11","1","8","3.40"
"107890","10","10","10","0","6","3.40"
"107924","11","11","10","1","7","3.40"
"108040","13","13","11","2","8","3.40"
"108075","11","11","9","2","5","3.40"
"108160","10","10","9","1","6","3.40"
"108372","12","12","11","1","7","3.40"
"108377","13","13","11","2","8","3.40"
"108413","13","13","11","2","7","3.40"
"108569","8","8","8","0","6","3.40"
"108649","14","13","14","0","9","3.40"
"108815","14","14","12","2","6","3.40"
"108837","15","15","15","0","11","3.40"
"108871","16","16","15","1","11","3.40"
"109014","16","16","14","2","6","3.40"
"109102","8","8","7","1","5","3.40"
"109166","12","12","10","2","8","3.40"
"109194","13","13","11","2","7","3.40"
"109263","14","14","10","4","6","3.40"
"109288","14","14","14","0","7","3.40"
"109411","8","8","8","0","5","3.40"
"109604","14","14","14","0","11","3.40"
"109637","10","10","9","1","5","3.40"
"109668","15","15","11","4","7","3.40"
"109677","14","14","13","1","7","3.40"
"109865","16","16","13","3","6","3.40"
"109982","18","18","15","3","10","3.40"
"109985","14","14","12","2","9","3.40"
"110140","8","8","7","1","5","3.40"
"110323","13","13","13","0","7","3.40"
"110477","12","12","10","2","8","3.40"
"110485","14","14","14","0","12","3.40"
"110542","11","11","8","3","7","3.40"
"110550","9","9","9","0","5","3.40"
"110569","8","8","7","1","5","3.40"
"110595","12","12","10","2","7","3.40"
"110804","9","9","8","1","6","3.40"
"111207","12","12","12","0","9","3.40"
"111290","12","12","11","1","7","3.40"
"111315","12","12","10","2","7","3.40"
"111338","12","12","9","3","8","3.40"
"111390","8","8","8","0","5","3.40"
"111443","17","17","16","1","7","3.40"
"111505","8","8","7","1","5","3.40"
"111571","17","17","15","2","10","3.40"
"111767","14","14","12","2","6","3.40"
"111840","7","7","7","0","5","3.40"
"111858","16","16","16","0","13","3.40"
"111979","14","14","13","1","8","3.40"
"112051","16","16","14","2","11","3.40"
"112096","14","14","11","3","6","3.40"
"112161","17","17","15","2","12","3.40"
"112165","12","12","11","1","6","3.40"
"112166","15","15","15","0","11","3.40"
"112207","9","9","8","1","5","3.40"
"112213","12","12","12","0","8","3.40"
"112372","9","9","9","0","6","3.40"
"112462","11","11","10","1","7","3.40"
"112517","11","11","10","1","9","3.40"
"112613","13","13","10","3","6","3.40"
"112646","17","17","16","1","10","3.40"
"112742","13","13","12","1","8","3.40"
"112904","12","12","11","1","6","3.40"
"112937","12","12","10","2","8","3.40"
"112947","11","11","11","0","5","3.40"
"112961","17","17","14","3","12","3.40"
"113045","10","10","9","1","5","3.40"
"113091","10","10","10","0","7","3.40"
"113109","10","10","10","0","7","3.40"
"113235","13","13","13","0","9","3.40"
"113548","17","17","16","1","12","3.40"
"113670","10","10","9","1","6","3.40"
"113870","15","15","14","1","10","3.40"
"114317","16","16","15","1","6","3.40"
"114332","17","17","17","0","15","3.40"
"114350","8","8","7","1","5","3.40"
"114441","11","11","10","1","7","3.40"
"114520","10","10","10","0","6","3.40"
"114641","12","12","10","2","7","3.40"
"114662","12","12","10","2","7","3.40"
"114667","12","12","12","0","8","3.40"
"114707","9","9","8","1","6","3.40"
"114917","12","11","10","2","7","3.40"
"114925","16","16","14","2","8","3.40"
"114973","14","14","11","3","9","3.40"
"114984","10","10","8","2","8","3.40"
"115003","7","7","6","1","5","3.40"
"115501","12","12","10","2","7","3.40"
"115520","11","11","10","1","6","3.40"
"115523","15","15","15","0","13","3.40"
"115720","8","8","8","0","6","3.40"
"115737","11","11","9","2","5","3.40"
"115780","16","16","11","5","5","3.40"
"115832","10","10","10","0","5","3.40"
"115851","23","23","20","3","14","3.40"
"116155","15","15","14","1","10","3.40"
"116195","7","7","7","0","5","3.40"
"116235","10","10","8","2","6","3.40"
"116250","13","13","12","1","7","3.40"
"116307","11","10","8","3","6","3.40"
"116409","13","13","12","1","6","3.40"
"116416","13","13","12","1","7","3.40"
"116500","18","18","18","0","12","3.40"
"116528","12","12","11","1","6","3.40"
"116529","15","15","15","0","13","3.40"
"116558","13","13","12","1","8","3.40"
"116642","20","20","19","1","16","3.40"
"116664","16","16","14","2","10","3.40"
"116694","10","10","10","0","5","3.40"
"117204","12","12","10","2","7","3.40"
"117385","13","13","12","1","8","3.40"
"117506","20","20","20","0","11","3.40"
"117554","12","12","11","1","6","3.40"
"117574","22","22","21","1","11","3.40"
"117579","15","15","14","1","10","3.40"
"100114","14","14","14","0","11","3.39"
"100251","13","13","11","2","9","3.39"
"100537","18","18","17","1","12","3.39"
"100642","21","21","17","4","12","3.39"
"100862","18","18","16","2","11","3.39"
"100948","19","19","15","4","11","3.39"
"101351","15","15","15","0","12","3.39"
"101720","12","12","11","1","9","3.39"
"102514","10","10","10","0","10","3.39"
"102787","15","15","15","0","11","3.39"
"102858","16","16","14","2","12","3.39"
"103414","10","10","9","1","9","3.39"
"104375","14","14","14","0","12","3.39"
"104878","12","12","12","0","8","3.39"
"105321","20","20","19","1","15","3.39"
"105462","18","18","17","1","8","3.39"
"106030","15","15","14","1","10","3.39"
"106162","16","16","12","4","8","3.39"
"106242","14","14","11","3","8","3.39"
"106336","14","14","12","2","9","3.39"
"106626","16","16","15","1","11","3.39"
"106922","12","12","12","0","8","3.39"
"107041","25","25","23","2","17","3.39"
"107137","16","16","16","0","12","3.39"
"107510","14","14","13","1","9","3.39"
"107648","16","16","15","1","11","3.39"
"107864","11","11","7","4","6","3.39"
"107914","16","16","14","2","10","3.39"
"108405","20","20","17","3","10","3.39"
"108708","19","19","17","2","16","3.39"
"109201","26","26","25","1","17","3.39"
"110067","16","15","16","0","14","3.39"
"110929","16","16","14","2","9","3.39"
"111723","21","21","20","1","16","3.39"
"111802","15","15","14","1","12","3.39"
"111827","18","18","17","1","11","3.39"
"112095","21","21","19","2","15","3.39"
"112188","24","24","23","1","18","3.39"
"112230","13","13","12","1","9","3.39"
"112246","15","15","13","2","9","3.39"
"112266","14","14","13","1","8","3.39"
"112298","19","19","19","0","10","3.39"
"112612","16","16","12","4","9","3.39"
"113363","16","16","15","1","11","3.39"
"113788","16","16","16","0","12","3.39"
"113884","17","17","15","2","10","3.39"
"114087","16","16","16","0","12","3.39"
"114097","12","12","12","0","9","3.39"
"114247","12","12","12","0","8","3.39"
"114263","16","16","15","1","9","3.39"
"114623","15","15","13","2","9","3.39"
"115801","15","15","14","1","11","3.39"
"116232","18","18","17","1","10","3.39"
"116853","18","18","16","2","12","3.39"
"117161","16","16","13","3","8","3.39"
"117231","18","18","15","3","10","3.39"
"117245","12","12","11","1","6","3.39"
"117432","13","13","12","1","10","3.39"
"117591","17","17","16","1","9","3.39"
"100077","12","12","9","3","5","3.38"
"100109","12","12","11","1","7","3.38"
"100210","11","11","10","1","6","3.38"
"100382","18","18","14","4","11","3.38"
"100513","8","8","8","0","5","3.38"
"100618","8","8","7","1","5","3.38"
"100742","12","12","9","3","6","3.38"
"100790","11","11","11","0","7","3.38"
"101120","9","9","9","0","8","3.38"
"101169","13","13","13","0","10","3.38"
"101357","14","14","13","1","5","3.38"
"101449","11","11","11","0","5","3.38"
"101497","10","10","8","2","5","3.38"
"101605","17","17","16","1","14","3.38"
"101914","19","19","18","1","12","3.38"
"101993","15","15","13","2","6","3.38"
"102211","11","11","10","1","7","3.38"
"102253","14","14","14","0","10","3.38"
"102400","10","10","9","1","6","3.38"
"102430","19","19","15","4","11","3.38"
"102434","12","12","11","1","9","3.38"
"102500","10","10","9","1","5","3.38"
"102588","10","10","9","1","5","3.38"
"102716","16","16","14","2","10","3.38"
"102731","18","18","18","0","11","3.38"
"102881","14","14","13","1","5","3.38"
"102955","7","7","7","0","5","3.38"
"103132","8","8","6","2","5","3.38"
"103199","9","9","8","1","6","3.38"
"103288","9","9","8","1","5","3.38"
"103396","12","12","12","0","5","3.38"
"103509","19","19","17","2","11","3.38"
"103596","12","12","11","1","9","3.38"
"103865","17","17","14","3","11","3.38"
"103899","6","6","6","0","5","3.38"
"103969","21","21","21","0","16","3.38"
"104119","12","12","11","1","9","3.38"
"104127","11","11","10","1","5","3.38"
"104322","13","13","13","0","10","3.38"
"104346","15","15","13","2","8","3.38"
"104422","20","20","14","6","10","3.38"
"104587","15","15","15","0","11","3.38"
"104887","11","11","10","1","6","3.38"
"104951","13","13","10","3","8","3.38"
"105030","15","15","14","1","11","3.38"
"105031","17","17","16","1","11","3.38"
"105092","16","16","15","1","9","3.38"
"105356","22","22","20","2","14","3.38"
"105773","15","15","14","1","12","3.38"
"105832","14","14","13","1","12","3.38"
"105904","15","14","14","1","11","3.38"
"105908","13","13","13","0","11","3.38"
"105915","13","13","10","3","6","3.38"
"106020","11","11","11","0","7","3.38"
"106068","14","14","13","1","11","3.38"
"106113","8","8","8","0","5","3.38"
"106114","15","15","13","2","10","3.38"
"106287","15","15","14","1","10","3.38"
"106288","17","17","12","5","9","3.38"
"106418","14","14","11","3","7","3.38"
"106529","11","11","11","0","9","3.38"
"106764","11","11","9","2","5","3.38"
"106810","10","10","10","0","9","3.38"
"106920","11","11","11","0","7","3.38"
"106942","16","16","14","2","10","3.38"
"106981","16","16","16","0","13","3.38"
"107029","18","18","15","3","12","3.38"
"107105","12","12","12","0","9","3.38"
"107360","19","19","18","1","9","3.38"
"107744","12","12","10","2","7","3.38"
"107851","20","20","19","1","12","3.38"
"107883","9","9","8","1","6","3.38"
"107903","10","10","9","1","6","3.38"
"108023","14","13","13","1","11","3.38"
"108035","15","15","14","1","7","3.38"
"108103","22","22","21","1","16","3.38"
"108204","13","13","13","0","10","3.38"
"108290","16","16","15","1","10","3.38"
"108328","14","14","12","2","10","3.38"
"108381","10","10","10","0","5","3.38"
"108721","11","11","10","1","5","3.38"
"108764","16","16","14","2","11","3.38"
"108804","19","19","19","0","14","3.38"
"108805","14","14","11","3","9","3.38"
"108826","12","12","11","1","7","3.38"
"109015","11","11","10","1","5","3.38"
"109087","17","17","16","1","14","3.38"
"109225","13","13","11","2","7","3.38"
"109251","10","10","8","2","7","3.38"
"109334","16","16","16","0","10","3.38"
"109549","12","12","10","2","5","3.38"
"109584","23","23","18","5","12","3.38"
"109603","10","10","9","1","5","3.38"
"109618","17","17","17","0","12","3.38"
"109876","16","16","15","1","11","3.38"
"110285","12","12","9","3","5","3.38"
"110375","10","10","8","2","5","3.38"
"110431","19","19","18","1","15","3.38"
"110592","14","14","13","1","11","3.38"
"110641","16","16","14","2","11","3.38"
"110658","9","9","8","1","6","3.38"
"110672","19","19","16","3","14","3.38"
"110805","15","15","13","2","10","3.38"
"110826","16","16","16","0","9","3.38"
"110863","11","11","10","1","9","3.38"
"110910","15","15","12","3","8","3.38"
"110950","15","15","14","1","9","3.38"
"111159","11","11","11","0","6","3.38"
"111164","14","14","12","2","10","3.38"
"111256","10","10","10","0","6","3.38"
"111288","17","17","14","3","11","3.38"
"111622","18","18","15","3","11","3.38"
"111672","12","12","12","0","10","3.38"
"111714","19","19","15","4","11","3.38"
"111730","16","16","13","3","10","3.38"
"111824","9","9","9","0","5","3.38"
"111839","11","11","8","3","5","3.38"
"111847","13","13","10","3","7","3.38"
"111903","14","14","13","1","11","3.38"
"111912","13","13","9","4","6","3.38"
"111970","9","9","7","2","6","3.38"
"112008","15","15","12","3","9","3.38"
"112070","15","15","15","0","12","3.38"
"112396","15","15","14","1","10","3.38"
"112458","10","10","8","2","6","3.38"
"112488","14","14","14","0","12","3.38"
"112762","12","12","10","2","6","3.38"
"112770","11","11","10","1","7","3.38"
"112998","19","19","18","1","14","3.38"
"113210","14","14","12","2","8","3.38"
"113283","9","9","8","1","6","3.38"
"113290","12","12","9","3","6","3.38"
"113374","13","13","11","2","7","3.38"
"113445","12","12","11","1","9","3.38"
"113678","14","14","13","1","10","3.38"
"113731","11","11","10","1","8","3.38"
"113933","13","13","10","3","6","3.38"
"113985","17","17","14","3","7","3.38"
"114122","20","20","19","1","13","3.38"
"114383","17","17","17","0","14","3.38"
"114390","26","26","23","3","15","3.38"
"114521","15","15","15","0","6","3.38"
"114551","18","18","17","1","13","3.38"
"114642","21","21","20","1","16","3.38"
"114696","9","9","9","0","5","3.38"
"114809","14","14","13","1","10","3.38"
"114837","10","10","9","1","6","3.38"
"114853","13","13","13","0","10","3.38"
"115314","12","12","11","1","9","3.38"
"115349","14","14","12","2","7","3.38"
"115408","13","13","12","1","11","3.38"
"115409","22","22","21","1","18","3.38"
"115463","19","19","16","3","14","3.38"
"115561","15","15","13","2","10","3.38"
"115637","10","10","8","2","6","3.38"
"115815","10","10","10","0","6","3.38"
"116041","13","13","12","1","8","3.38"
"116137","17","17","15","2","10","3.38"
"116158","21","21","18","3","11","3.38"
"116219","15","15","14","1","12","3.38"
"116236","12","12","10","2","7","3.38"
"116342","16","16","16","0","8","3.38"
"116471","16","16","15","1","11","3.38"
"116511","8","8","7","1","5","3.38"
"116557","11","11","10","1","9","3.38"
"116651","17","17","16","1","9","3.38"
"116793","19","19","18","1","10","3.38"
"116795","11","11","11","0","5","3.38"
"116799","13","13","12","1","9","3.38"
"116843","18","18","17","1","14","3.38"
"116867","8","8","8","0","5","3.38"
"116881","9","9","8","1","8","3.38"
"116940","13","13","11","2","6","3.38"
"116965","12","12","11","1","8","3.38"
"116974","10","10","8","2","5","3.38"
"117154","12","12","11","1","9","3.38"
"117517","15","15","13","2","11","3.38"
"117568","10","10","10","0","6","3.38"
"100741","20","20","18","2","15","3.37"
"101146","21","20","21","0","16","3.37"
"101172","23","23","19","4","16","3.37"
"101661","14","14","9","5","8","3.37"
"101662","18","18","17","1","14","3.37"
"101923","15","15","14","1","10","3.37"
"101969","19","19","16","3","11","3.37"
"102764","22","22","18","4","11","3.37"
"103217","23","23","20","3","12","3.37"
"103712","17","17","17","0","13","3.37"
"104120","13","13","12","1","8","3.37"
"105298","17","17","13","4","9","3.37"
"105604","15","15","14","1","10","3.37"
"106544","13","13","12","1","11","3.37"
"106805","13","13","11","2","8","3.37"
"106989","14","14","12","2","9","3.37"
"108340","17","17","17","0","11","3.37"
"108401","16","16","14","2","9","3.37"
"108591","16","16","14","2","8","3.37"
"109572","18","18","17","1","11","3.37"
"111575","22","21","20","2","14","3.37"
"112776","16","16","16","0","12","3.37"
"113680","11","11","10","1","9","3.37"
"114032","17","17","16","1","14","3.37"
"114129","18","18","16","2","12","3.37"
"115577","18","18","17","1","13","3.37"
"115776","12","12","10","2","8","3.37"
"116119","16","16","12","4","9","3.37"
"117076","21","20","20","1","14","3.37"
"117418","16","16","16","0","14","3.37"
"100090","12","12","11","1","9","3.36"
"100126","19","19","16","3","11","3.36"
"100226","16","16","14","2","11","3.36"
"100309","12","12","12","0","10","3.36"
"100490","16","16","15","1","12","3.36"
"100495","18","18","16","2","11","3.36"
"100508","15","15","14","1","11","3.36"
"100595","15","14","14","1","13","3.36"
"100619","15","15","13","2","10","3.36"
"100655","19","19","18","1","16","3.36"
"100730","21","21","17","4","12","3.36"
"100744","12","12","11","1","9","3.36"
"100871","16","16","15","1","10","3.36"
"100956","16","16","13","3","11","3.36"
"101318","11","11","11","0","9","3.36"
"101360","20","20","18","2","14","3.36"
"101415","19","19","18","1","11","3.36"
"101546","14","14","14","0","9","3.36"
"101651","18","18","17","1","13","3.36"
"101673","13","13","12","1","8","3.36"
"101698","15","15","11","4","9","3.36"
"102002","26","26","23","3","13","3.36"
"102034","22","22","21","1","12","3.36"
"102158","13","13","10","3","9","3.36"
"102305","12","12","12","0","8","3.36"
"102639","18","18","15","3","14","3.36"
"102692","16","16","14","2","8","3.36"
"102856","15","15","13","2","8","3.36"
"103165","13","13","13","0","9","3.36"
"103398","13","13","12","1","9","3.36"
"103811","18","18","14","4","10","3.36"
"103895","13","13","12","1","11","3.36"
"104441","13","13","13","0","11","3.36"
"104571","13","13","12","1","9","3.36"
"104939","16","16","13","3","10","3.36"
"105265","12","12","10","2","8","3.36"
"105438","14","13","12","2","9","3.36"
"105484","24","24","24","0","18","3.36"
"105555","13","13","13","0","9","3.36"
"105621","14","14","14","0","9","3.36"
"105746","19","19","19","0","15","3.36"
"105876","16","16","15","1","10","3.36"
"106024","19","19","16","3","11","3.36"
"106075","22","22","19","3","12","3.36"
"106180","14","14","13","1","9","3.36"
"106337","15","15","14","1","10","3.36"
"106374","22","22","19","3","15","3.36"
"106637","13","13","12","1","9","3.36"
"106694","14","14","13","1","9","3.36"
"106801","14","14","13","1","10","3.36"
"106917","14","14","14","0","10","3.36"
"106979","15","15","15","0","10","3.36"
"107683","10","10","9","1","8","3.36"
"107775","15","14","13","2","10","3.36"
"107949","24","24","22","2","14","3.36"
"108418","15","15","15","0","10","3.36"
"108677","12","12","11","1","8","3.36"
"108715","15","15","12","3","9","3.36"
"108758","15","15","14","1","11","3.36"
"109382","19","19","15","4","9","3.36"
"110390","13","13","12","1","9","3.36"
"110528","14","14","13","1","8","3.36"
"110687","14","14","13","1","9","3.36"
"110845","23","23","23","0","17","3.36"
"110937","17","17","16","1","11","3.36"
"111089","17","17","16","1","12","3.36"
"111180","15","15","14","1","8","3.36"
"111428","15","15","12","3","9","3.36"
"111609","14","14","14","0","9","3.36"
"112039","14","14","13","1","10","3.36"
"112706","11","11","11","0","8","3.36"
"112782","13","13","11","2","11","3.36"
"112869","12","12","11","1","9","3.36"
"112880","13","13","11","2","9","3.36"
"112884","13","13","12","1","8","3.36"
"113160","18","18","16","2","8","3.36"
"113174","13","13","12","1","9","3.36"
"113377","17","17","15","2","13","3.36"
"113553","16","16","16","0","12","3.36"
"113560","10","10","10","0","8","3.36"
"114071","12","12","10","2","9","3.36"
"114107","11","11","10","1","8","3.36"
"114322","15","15","12","3","9","3.36"
"114347","11","11","11","0","9","3.36"
"114496","15","15","12","3","9","3.36"
"114880","13","13","13","0","10","3.36"
"114953","14","14","13","1","12","3.36"
"115189","20","20","20","0","10","3.36"
"115528","16","16","13","3","10","3.36"
"115609","12","12","12","0","9","3.36"
"115974","17","17","15","2","8","3.36"
"116093","19","19","15","4","9","3.36"
"116110","19","19","17","2","14","3.36"
"116118","12","12","10","2","10","3.36"
"116264","12","12","11","1","9","3.36"
"117019","16","16","14","2","9","3.36"
"117080","16","16","14","2","9","3.36"
"117201","16","16","13","3","11","3.36"
"100022","18","18","18","0","13","3.35"
"100593","19","19","16","3","11","3.35"
"100769","16","16","15","1","12","3.35"
"101442","14","14","13","1","11","3.35"
"102078","18","18","18","0","15","3.35"
"104061","23","23","21","2","14","3.35"
"104146","10","10","9","1","8","3.35"
"104465","13","13","13","0","12","3.35"
"104983","24","24","23","1","15","3.35"
"106627","18","18","16","2","11","3.35"
"107550","18","18","14","4","9","3.35"
"108004","18","18","18","0","14","3.35"
"108125","19","19","19","0","11","3.35"
"108894","18","18","17","1","13","3.35"
"111165","15","15","14","1","8","3.35"
"111210","20","20","19","1","15","3.35"
"113480","15","15","15","0","14","3.35"
"113589","19","19","19","0","13","3.35"
"113666","15","15","15","0","14","3.35"
"114093","14","14","13","1","9","3.35"
"114948","22","22","19","3","14","3.35"
"115332","18","18","16","2","16","3.35"
"115964","12","12","11","1","8","3.35"
"116992","14","14","13","1","11","3.35"
"117053","17","17","15","2","13","3.35"
"103696","9","9","7","2","4","3.34"
"103730","13","13","13","0","9","3.34"
"106026","13","13","12","1","9","3.34"
"106399","8","8","6","2","4","3.34"
"107845","8","8","8","0","5","3.34"
"109924","16","16","16","0","14","3.34"
"111342","17","17","16","1","12","3.34"
"111396","16","16","16","0","12","3.34"
"111693","16","16","16","0","12","3.34"
"115572","20","20","17","3","13","3.34"
"100042","7","7","6","1","3","3.33"
"100056","9","9","6","3","4","3.33"
"100240","19","19","17","2","14","3.33"
"100385","6","6","6","0","4","3.33"
"100387","19","19","18","1","12","3.33"
"100394","17","17","16","1","12","3.33"
"100419","13","13","12","1","9","3.33"
"100480","12","12","10","2","7","3.33"
"100497","18","18","16","2","9","3.33"
"100519","13","13","11","2","9","3.33"
"100526","9","9","8","1","6","3.33"
"100538","18","18","16","2","9","3.33"
"100563","12","12","10","2","8","3.33"
"100620","7","7","7","0","3","3.33"
"100637","10","10","9","1","6","3.33"
"100674","13","13","13","0","10","3.33"
"100701","5","5","4","1","3","3.33"
"100745","9","9","9","0","8","3.33"
"100749","11","11","11","0","8","3.33"
"100832","11","11","7","4","3","3.33"
"100939","16","16","15","1","9","3.33"
"100944","13","13","12","1","9","3.33"
"100988","18","18","15","3","7","3.33"
"101012","14","14","10","4","7","3.33"
"101090","16","16","14","2","4","3.33"
"101119","19","19","15","4","8","3.33"
"101134","16","16","15","1","11","3.33"
"101275","6","6","4","2","3","3.33"
"101327","13","13","13","0","8","3.33"
"101355","6","6","6","0","4","3.33"
"101356","17","17","16","1","14","3.33"
"101405","14","14","11","3","10","3.33"
"101503","14","14","14","0","11","3.33"
"101542","10","10","8","2","4","3.33"
"101598","16","16","13","3","9","3.33"
"101721","16","16","15","1","12","3.33"
"101726","10","10","9","1","7","3.33"
"101752","16","16","11","5","6","3.33"
"101855","14","13","13","1","9","3.33"
"102033","12","12","12","0","7","3.33"
"102070","10","10","9","1","9","3.33"
"102164","27","27","26","1","15","3.33"
"102199","9","9","8","1","3","3.33"
"102252","17","17","13","4","10","3.33"
"102327","17","17","17","0","13","3.33"
"102345","12","12","11","1","6","3.33"
"102393","13","13","12","1","7","3.33"
"102479","15","15","10","5","6","3.33"
"102553","15","15","14","1","10","3.33"
"102755","14","14","12","2","9","3.33"
"102756","7","7","6","1","4","3.33"
"102781","7","7","6","1","3","3.33"
"102870","11","11","10","1","7","3.33"
"102962","9","9","9","0","6","3.33"
"103011","16","16","13","3","7","3.33"
"103021","16","16","14","2","9","3.33"
"103056","16","16","12","4","8","3.33"
"103064","9","9","8","1","6","3.33"
"103104","14","14","14","0","9","3.33"
"103198","15","15","12","3","7","3.33"
"103263","14","14","14","0","7","3.33"
"103264","13","13","10","3","8","3.33"
"103309","16","16","15","1","13","3.33"
"103323","13","13","11","2","3","3.33"
"103352","12","12","12","0","4","3.33"
"103368","16","16","14","2","11","3.33"
"103404","15","15","13","2","9","3.33"
"103454","11","11","8","3","3","3.33"
"103501","12","12","10","2","7","3.33"
"103532","12","12","9","3","4","3.33"
"103853","12","12","11","1","10","3.33"
"103912","18","18","18","0","13","3.33"
"103951","17","17","16","1","10","3.33"
"104033","6","6","6","0","3","3.33"
"104052","10","10","7","3","3","3.33"
"104153","22","22","20","2","14","3.33"
"104198","11","11","8","3","6","3.33"
"104200","9","9","8","1","4","3.33"
"104234","12","12","12","0","8","3.33"
"104256","12","12","10","2","7","3.33"
"104316","12","12","12","0","8","3.33"
"104357","7","7","7","0","3","3.33"
"104384","12","12","11","1","3","3.33"
"104486","13","13","13","0","8","3.33"
"104592","15","15","12","3","9","3.33"
"104741","20","20","18","2","11","3.33"
"104781","16","16","14","2","12","3.33"
"104792","13","13","12","1","10","3.33"
"104982","14","14","14","0","10","3.33"
"105077","11","11","11","0","7","3.33"
"105141","10","10","9","1","7","3.33"
"105177","9","9","7","2","3","3.33"
"105180","8","8","7","1","6","3.33"
"105278","12","12","11","1","8","3.33"
"105331","19","19","16","3","12","3.33"
"105373","18","18","17","1","13","3.33"
"105400","16","16","13","3","6","3.33"
"105431","14","14","14","0","9","3.33"
"105443","15","15","13","2","10","3.33"
"105511","12","12","12","0","12","3.33"
"105570","19","19","16","3","12","3.33"
"105617","17","17","14","3","9","3.33"
"105628","19","19","18","1","13","3.33"
"105694","14","14","12","2","7","3.33"
"105732","15","15","15","0","11","3.33"
"105745","8","8","6","2","3","3.33"
"105771","14","14","10","4","7","3.33"
"105799","15","15","15","0","11","3.33"
"105885","7","7","6","1","4","3.33"
"105945","15","15","15","0","10","3.33"
"105989","15","15","13","2","9","3.33"
"106031","16","16","13","3","9","3.33"
"106032","11","11","10","1","8","3.33"
"106050","15","15","12","3","9","3.33"
"106055","13","13","13","0","4","3.33"
"106137","19","19","16","3","9","3.33"
"106177","14","14","11","3","6","3.33"
"106298","15","15","14","1","9","3.33"
"106366","10","10","8","2","4","3.33"
"106380","10","10","8","2","4","3.33"
"106413","17","17","16","1","13","3.33"
"106433","8","8","8","0","6","3.33"
"106545","9","9","8","1","6","3.33"
"106561","8","8","7","1","4","3.33"
"106624","7","7","7","0","3","3.33"
"106660","10","10","9","1","7","3.33"
"106667","16","16","14","2","9","3.33"
"106700","17","17","17","0","9","3.33"
"106762","8","8","8","0","7","3.33"
"106800","7","7","6","1","4","3.33"
"106874","12","12","12","0","6","3.33"
"106881","12","12","10","2","7","3.33"
"106895","8","8","7","1","3","3.33"
"107004","11","11","11","0","7","3.33"
"107052","12","12","12","0","9","3.33"
"107091","12","12","11","1","9","3.33"
"107190","18","18","17","1","12","3.33"
"107246","11","11","8","3","6","3.33"
"107308","17","17","15","2","9","3.33"
"107348","17","17","16","1","12","3.33"
"107454","17","17","16","1","8","3.33"
"107541","19","19","17","2","13","3.33"
"107714","19","19","17","2","9","3.33"
"107720","15","15","12","3","10","3.33"
"107770","8","8","7","1","6","3.33"
"107796","14","14","12","2","8","3.33"
"107809","17","17","15","2","10","3.33"
"107850","13","13","10","3","9","3.33"
"107855","18","18","17","1","8","3.33"
"107968","11","11","10","1","6","3.33"
"108071","11","11","11","0","8","3.33"
"108074","18","18","13","5","8","3.33"
"108089","12","12","11","1","8","3.33"
"108111","12","12","10","2","9","3.33"
"108329","15","15","15","0","10","3.33"
"108356","8","8","5","3","3","3.33"
"108397","21","21","18","3","13","3.33"
"108416","14","14","13","1","9","3.33"
"108505","13","13","13","0","7","3.33"
"108573","13","13","8","5","5","3.33"
"108592","12","12","11","1","10","3.33"
"108605","10","10","10","0","6","3.33"
"108609","16","16","13","3","7","3.33"
"108618","15","15","15","0","12","3.33"
"108632","10","10","7","3","7","3.33"
"108644","20","20","18","2","15","3.33"
"108651","13","13","11","2","6","3.33"
"108726","18","18","14","4","11","3.33"
"108808","19","19","19","0","16","3.33"
"108850","13","13","12","1","11","3.33"
"108898","14","14","13","1","9","3.33"
"108924","19","19","18","1","12","3.33"
"108951","18","18","15","3","11","3.33"
"108984","22","22","21","1","19","3.33"
"108990","11","11","10","1","7","3.33"
"109002","12","12","12","0","11","3.33"
"109026","17","17","17","0","11","3.33"
"109027","12","12","11","1","6","3.33"
"109049","12","12","10","2","9","3.33"
"109128","16","16","14","2","7","3.33"
"109185","14","14","12","2","8","3.33"
"109229","17","17","15","2","12","3.33"
"109350","7","7","7","0","6","3.33"
"109394","11","11","10","1","6","3.33"
"109400","26","26","21","5","13","3.33"
"109413","11","11","10","1","8","3.33"
"109453","14","14","12","2","6","3.33"
"109460","21","21","20","1","16","3.33"
"109557","12","12","11","1","7","3.33"
"109560","11","11","10","1","3","3.33"
"109619","11","11","10","1","6","3.33"
"109843","19","19","17","2","11","3.33"
"110084","18","18","17","1","12","3.33"
"110087","7","7","6","1","3","3.33"
"110261","15","15","13","2","7","3.33"
"110342","16","16","15","1","9","3.33"
"110356","12","12","11","1","8","3.33"
"110437","6","6","6","0","3","3.33"
"110473","17","17","16","1","10","3.33"
"110627","16","16","15","1","10","3.33"
"110682","13","13","11","2","6","3.33"
"110689","19","19","16","3","9","3.33"
"110751","10","10","9","1","7","3.33"
"110759","16","16","15","1","12","3.33"
"110783","11","11","9","2","6","3.33"
"110834","13","13","13","0","9","3.33"
"110838","16","16","11","5","8","3.33"
"110849","13","13","11","2","8","3.33"
"110858","12","12","11","1","7","3.33"
"110872","9","9","9","0","8","3.33"
"110886","21","21","18","3","14","3.33"
"110933","17","17","15","2","12","3.33"
"110998","18","18","15","3","10","3.33"
"111043","9","9","9","0","6","3.33"
"111120","13","13","12","1","10","3.33"
"111243","17","17","16","1","15","3.33"
"111308","22","22","19","3","14","3.33"
"111337","10","10","9","1","6","3.33"
"111355","21","21","21","0","15","3.33"
"111423","13","13","10","3","7","3.33"
"111465","17","17","16","1","12","3.33"
"111487","16","16","10","6","4","3.33"
"111517","11","11","10","1","7","3.33"
"111553","12","12","12","0","9","3.33"
"111579","8","8","6","2","4","3.33"
"111584","12","12","10","2","3","3.33"
"111660","19","19","16","3","9","3.33"
"111784","11","11","11","0","8","3.33"
"111797","6","6","6","0","3","3.33"
"111825","13","13","13","0","9","3.33"
"111985","16","16","16","0","12","3.33"
"112012","13","13","12","1","10","3.33"
"112214","12","12","11","1","7","3.33"
"112238","7","7","6","1","4","3.33"
"112318","7","7","7","0","3","3.33"
"112355","8","8","8","0","8","3.33"
"112491","11","11","11","0","7","3.33"
"112494","12","12","10","2","8","3.33"
"112559","8","8","7","1","3","3.33"
"112581","20","20","18","2","13","3.33"
"112614","13","13","12","1","11","3.33"
"112694","13","13","12","1","9","3.33"
"112719","8","8","7","1","3","3.33"
"112724","8","8","8","0","5","3.33"
"112736","18","18","16","2","11","3.33"
"112737","14","14","12","2","10","3.33"
"112792","10","10","7","3","3","3.33"
"112823","8","8","8","0","4","3.33"
"112834","20","20","20","0","13","3.33"
"112876","16","16","15","1","9","3.33"
"112877","10","10","9","1","3","3.33"
"112914","14","14","12","2","5","3.33"
"112940","12","12","9","3","3","3.33"
"113070","5","5","4","1","3","3.33"
"113219","14","14","11","3","7","3.33"
"113246","12","12","11","1","6","3.33"
"113274","14","14","11","3","9","3.33"
"113332","11","11","10","1","6","3.33"
"113340","8","8","8","0","7","3.33"
"113345","14","14","13","1","7","3.33"
"113347","12","12","10","2","8","3.33"
"113388","14","14","14","0","7","3.33"
"113401","15","15","12","3","8","3.33"
"113518","9","9","9","0","5","3.33"
"113550","14","14","13","1","7","3.33"
"113577","15","15","15","0","12","3.33"
"113604","15","15","13","2","10","3.33"
"113624","9","9","7","2","6","3.33"
"113673","16","16","14","2","12","3.33"
"113702","11","11","10","1","9","3.33"
"113860","16","16","16","0","10","3.33"
"113866","8","8","7","1","3","3.33"
"113894","9","9","8","1","6","3.33"
"113905","19","19","15","4","8","3.33"
"113916","14","14","11","3","8","3.33"
"114014","9","9","8","1","7","3.33"
"114079","11","11","6","5","3","3.33"
"114150","8","8","8","0","7","3.33"
"114160","15","15","13","2","9","3.33"
"114182","16","16","14","2","9","3.33"
"114192","14","14","13","1","8","3.33"
"114196","9","9","9","0","7","3.33"
"114225","6","6","6","0","3","3.33"
"114242","16","16","16","0","11","3.33"
"114269","15","15","15","0","7","3.33"
"114369","11","11","10","1","4","3.33"
"114387","13","13","11","2","7","3.33"
"114415","9","9","9","0","8","3.33"
"114501","10","10","10","0","8","3.33"
"114508","12","12","11","1","9","3.33"
"114529","11","11","9","2","7","3.33"
"114565","9","9","7","2","4","3.33"
"114636","14","14","14","0","11","3.33"
"114660","12","12","8","4","3","3.33"
"114672","9","9","9","0","4","3.33"
"114783","10","10","9","1","9","3.33"
"114883","11","11","11","0","9","3.33"
"114915","14","14","11","3","7","3.33"
"115063","17","17","15","2","11","3.33"
"115084","13","13","12","1","11","3.33"
"115085","14","14","13","1","10","3.33"
"115111","16","16","14","2","12","3.33"
"115205","14","14","12","2","6","3.33"
"115279","11","11","9","2","6","3.33"
"115418","23","23","22","1","16","3.33"
"115426","8","8","8","0","6","3.33"
"115432","10","10","10","0","8","3.33"
"115451","13","13","9","4","7","3.33"
"115465","12","12","10","2","8","3.33"
"115512","13","13","11","2","9","3.33"
"115548","8","8","8","0","4","3.33"
"115619","9","9","9","0","4","3.33"
"115760","8","8","7","1","3","3.33"
"115811","13","13","12","1","8","3.33"
"115834","14","14","14","0","7","3.33"
"115883","8","8","8","0","6","3.33"
"115888","19","19","17","2","15","3.33"
"115892","8","8","7","1","3","3.33"
"115903","12","12","11","1","8","3.33"
"115971","10","10","10","0","9","3.33"
"115975","9","9","8","1","8","3.33"
"116040","14","14","10","4","7","3.33"
"116112","11","11","11","0","7","3.33"
"116121","10","10","6","4","3","3.33"
"116142","10","10","9","1","7","3.33"
"116207","12","12","12","0","10","3.33"
"116262","14","14","13","1","12","3.33"
"116317","14","14","11","3","9","3.33"
"116359","16","16","13","3","6","3.33"
"116398","9","9","7","2","3","3.33"
"116423","19","19","19","0","15","3.33"
"116446","12","12","11","1","10","3.33"
"116479","8","8","7","1","6","3.33"
"116569","17","17","15","2","11","3.33"
"116629","21","21","19","2","12","3.33"
"116695","6","6","5","1","3","3.33"
"116748","6","6","6","0","3","3.33"
"116763","18","18","17","1","10","3.33"
"116982","18","18","17","1","13","3.33"
"116997","15","15","13","2","11","3.33"
"117018","10","10","8","2","4","3.33"
"117067","12","12","9","3","8","3.33"
"117078","7","7","6","1","4","3.33"
"117121","13","13","11","2","6","3.33"
"117141","10","10","10","0","8","3.33"
"117160","18","18","15","3","11","3.33"
"117212","14","14","13","1","9","3.33"
"117311","12","12","11","1","10","3.33"
"117314","11","11","10","1","6","3.33"
"117326","9","9","7","2","3","3.33"
"117381","7","7","7","0","3","3.33"
"117427","10","10","8","2","6","3.33"
"117471","10","10","9","1","5","3.33"
"117616","13","13","12","1","9","3.33"
"100865","16","16","15","1","15","3.32"
"101065","16","16","13","3","11","3.32"
"101464","20","20","18","2","13","3.32"
"101530","17","17","16","1","10","3.32"
"101564","19","19","16","3","10","3.32"
"103077","16","16","16","0","14","3.32"
"103493","19","19","17","2","16","3.32"
"104080","18","18","15","3","12","3.32"
"105379","15","15","11","4","10","3.32"
"106166","17","17","16","1","12","3.32"
"106494","15","15","15","0","13","3.32"
"107180","22","22","18","4","13","3.32"
"107834","15","15","15","0","12","3.32"
"108098","21","21","19","2","12","3.32"
"108334","15","15","14","1","11","3.32"
"108559","21","21","20","1","13","3.32"
"110314","16","16","14","2","12","3.32"
"112259","14","14","14","0","10","3.32"
"112622","19","19","18","1","11","3.32"
"114741","19","19","19","0","13","3.32"
"114947","14","14","13","1","11","3.32"
"115261","14","14","14","0","12","3.32"
"117529","14","14","13","1","11","3.32"
"100098","16","16","16","0","12","3.31"
"100103","17","17","15","2","12","3.31"
"100239","13","13","12","1","9","3.31"
"100543","14","14","13","1","11","3.31"
"100567","17","17","16","1","10","3.31"
"100597","15","15","15","0","10","3.31"
"100623","17","17","15","2","13","3.31"
"100816","12","12","11","1","8","3.31"
"100821","12","12","12","0","9","3.31"
"100854","14","14","12","2","11","3.31"
"100899","15","15","14","1","10","3.31"
"100967","19","19","19","0","15","3.31"
"101112","19","19","18","1","10","3.31"
"101123","16","16","14","2","10","3.31"
"101151","17","17","16","1","10","3.31"
"101227","16","16","13","3","11","3.31"
"101263","18","18","18","0","11","3.31"
"101337","16","16","14","2","12","3.31"
"101402","17","17","16","1","12","3.31"
"101445","18","18","16","2","11","3.31"
"101533","14","14","11","3","9","3.31"
"101786","17","17","14","3","13","3.31"
"102024","20","20","19","1","14","3.31"
"102124","13","13","12","1","11","3.31"
"102172","16","16","15","1","13","3.31"
"102366","14","14","13","1","10","3.31"
"102432","14","14","13","1","12","3.31"
"102490","12","12","11","1","9","3.31"
"102627","15","15","13","2","11","3.31"
"102727","15","15","14","1","11","3.31"
"103158","22","22","17","5","10","3.31"
"103331","16","16","13","3","11","3.31"
"103626","17","17","15","2","12","3.31"
"104279","18","18","18","0","12","3.31"
"104376","12","12","11","1","7","3.31"
"104477","16","16","15","1","10","3.31"
"104495","20","20","19","1","12","3.31"
"104528","17","17","15","2","11","3.31"
"104665","11","11","11","0","10","3.31"
"104998","18","18","15","3","10","3.31"
"105091","17","17","14","3","9","3.31"
"105264","18","18","18","0","13","3.31"
"105410","13","13","13","0","10","3.31"
"105712","19","19","15","4","11","3.31"
"106183","11","11","11","0","9","3.31"
"106238","15","15","14","1","9","3.31"
"106273","16","16","14","2","12","3.31"
"106396","18","18","17","1","14","3.31"
"106486","15","15","14","1","12","3.31"
"106489","12","12","10","2","9","3.31"
"106509","14","14","11","3","9","3.31"
"106580","17","17","14","3","9","3.31"
"106704","21","21","20","1","13","3.31"
"106825","14","14","12","2","8","3.31"
"106868","16","16","13","3","12","3.31"
"106935","14","14","12","2","9","3.31"
"107152","20","20","17","3","14","3.31"
"107272","17","17","17","0","15","3.31"
"107425","19","19","17","2","14","3.31"
"107447","15","15","15","0","11","3.31"
"107500","16","16","15","1","12","3.31"
"107951","20","20","19","1","13","3.31"
"107979","18","18","17","1","13","3.31"
"108291","13","13","13","0","11","3.31"
"108383","20","20","17","3","12","3.31"
"108389","21","21","21","0","10","3.31"
"108444","15","15","13","2","10","3.31"
"108464","12","12","11","1","10","3.31"
"108550","15","15","11","4","10","3.31"
"108933","18","18","17","1","10","3.31"
"108978","21","21","18","3","14","3.31"
"109456","13","13","12","1","8","3.31"
"109698","16","16","12","4","11","3.31"
"109718","23","23","19","4","15","3.31"
"110914","20","20","18","2","14","3.31"
"110993","13","13","13","0","10","3.31"
"111009","13","13","13","0","9","3.31"
"111236","15","15","14","1","12","3.31"
"111312","18","18","17","1","11","3.31"
"111344","16","16","15","1","14","3.31"
"111363","16","16","15","1","11","3.31"
"111522","17","17","15","2","10","3.31"
"111866","14","14","12","2","10","3.31"
"111982","10","10","10","0","9","3.31"
"111993","18","18","17","1","16","3.31"
"112141","13","13","11","2","9","3.31"
"112282","19","19","17","2","14","3.31"
"112375","17","17","15","2","10","3.31"
"112397","18","18","18","0","15","3.31"
"112555","18","18","17","1","13","3.31"
"112916","16","16","15","1","14","3.31"
"113227","19","19","19","0","11","3.31"
"113500","14","14","13","1","10","3.31"
"113651","11","11","10","1","8","3.31"
"113706","15","15","13","2","10","3.31"
"113763","15","15","15","0","12","3.31"
"113812","13","13","12","1","11","3.31"
"113930","14","14","14","0","12","3.31"
"113995","11","11","11","0","11","3.31"
"114066","14","14","14","0","11","3.31"
"114184","19","19","18","1","12","3.31"
"114206","18","18","15","3","12","3.31"
"114298","17","17","14","3","10","3.31"
"114582","17","17","16","1","14","3.31"
"114970","17","17","16","1","10","3.31"
"115013","16","16","14","2","11","3.31"
"115554","13","13","13","0","8","3.31"
"115585","18","18","16","2","13","3.31"
"115677","17","17","16","1","12","3.31"
"115913","11","11","10","1","10","3.31"
"116008","16","16","15","1","11","3.31"
"116225","18","18","16","2","10","3.31"
"116258","20","20","19","1","13","3.31"
"116477","16","16","14","2","12","3.31"
"116598","18","18","16","2","12","3.31"
"116849","19","19","17","2","11","3.31"
"117335","20","20","18","2","14","3.31"
"117596","16","16","15","1","9","3.31"
"100299","19","19","17","2","10","3.30"
"100306","20","20","19","1","13","3.30"
"100425","13","13","9","4","7","3.30"
"100582","19","19","17","2","8","3.30"
"100587","15","15","12","3","8","3.30"
"100606","11","11","11","0","8","3.30"
"100675","9","9","8","1","6","3.30"
"100866","20","20","20","0","16","3.30"
"100868","17","17","16","1","9","3.30"
"100880","18","18","15","3","10","3.30"
"100940","16","16","13","3","9","3.30"
"100975","11","11","10","1","6","3.30"
"101200","13","13","11","2","7","3.30"
"101203","18","18","16","2","9","3.30"
"101213","9","9","9","0","7","3.30"
"101483","14","14","12","2","6","3.30"
"101521","10","10","9","1","6","3.30"
"101541","9","9","9","0","6","3.30"
"101732","10","10","8","2","6","3.30"
"102001","15","15","11","4","7","3.30"
"102103","11","11","8","3","7","3.30"
"102133","13","13","13","0","6","3.30"
"102190","13","13","13","0","8","3.30"
"102231","10","10","10","0","6","3.30"
"102417","14","14","12","2","8","3.30"
"102794","22","22","21","1","16","3.30"
"103139","13","13","12","1","10","3.30"
"103247","10","10","10","0","9","3.30"
"103306","12","12","9","3","6","3.30"
"103399","13","13","13","0","9","3.30"
"103403","23","23","23","0","17","3.30"
"103442","9","9","8","1","6","3.30"
"103477","15","15","13","2","7","3.30"
"103669","23","23","23","0","20","3.30"
"103828","14","14","11","3","9","3.30"
"103835","14","14","12","2","8","3.30"
"103958","12","12","11","1","7","3.30"
"104197","18","18","16","2","9","3.30"
"104323","15","15","11","4","6","3.30"
"104365","11","11","10","1","8","3.30"
"104392","21","21","21","0","17","3.30"
"104406","9","9","9","0","6","3.30"
"104494","10","10","9","1","6","3.30"
"104580","11","11","10","1","6","3.30"
"104905","11","11","9","2","6","3.30"
"104908","10","10","7","3","7","3.30"
"104911","13","13","12","1","8","3.30"
"105060","17","17","14","3","7","3.30"
"105104","12","12","10","2","6","3.30"
"105110","7","7","6","1","6","3.30"
"105148","8","8","8","0","6","3.30"
"105201","12","12","11","1","7","3.30"
"105562","9","9","8","1","7","3.30"
"105741","21","21","19","2","10","3.30"
"105785","14","14","13","1","8","3.30"
"106156","12","12","11","1","9","3.30"
"106373","13","13","11","2","6","3.30"
"106389","10","10","10","0","6","3.30"
"106584","18","18","16","2","12","3.30"
"106688","9","9","9","0","6","3.30"
"106766","12","12","12","0","9","3.30"
"106775","12","12","10","2","8","3.30"
"106821","11","11","11","0","8","3.30"
"106965","15","15","12","3","9","3.30"
"106996","19","19","15","4","7","3.30"
"107020","16","16","12","4","6","3.30"
"107340","16","16","15","1","13","3.30"
"107367","13","13","8","5","6","3.30"
"107572","16","16","16","0","8","3.30"
"107698","19","19","19","0","14","3.30"
"107867","15","15","11","4","9","3.30"
"107944","13","13","13","0","7","3.30"
"108037","11","11","11","0","9","3.30"
"108247","14","14","13","1","7","3.30"
"108261","8","8","7","1","6","3.30"
"108398","10","10","10","0","7","3.30"
"108731","16","16","15","1","9","3.30"
"108770","21","21","19","2","14","3.30"
"109028","14","14","11","3","6","3.30"
"109050","9","9","8","1","7","3.30"
"109107","15","15","14","1","9","3.30"
"109224","17","17","17","0","12","3.30"
"109275","14","14","13","1","7","3.30"
"109435","10","10","9","1","8","3.30"
"109451","16","16","13","3","7","3.30"
"109498","19","19","17","2","13","3.30"
"109892","13","13","12","1","7","3.30"
"109893","21","21","19","2","15","3.30"
"110282","10","10","9","1","7","3.30"
"110290","14","14","13","1","8","3.30"
"110494","9","9","8","1","6","3.30"
"110496","15","15","15","0","13","3.30"
"110864","17","17","17","0","14","3.30"
"110868","17","17","16","1","11","3.30"
"110882","13","13","12","1","6","3.30"
"110946","11","11","9","2","6","3.30"
"110947","12","12","11","1","9","3.30"
"111053","16","16","16","0","8","3.30"
"111057","18","18","13","5","8","3.30"
"111068","10","10","9","1","7","3.30"
"111109","12","12","10","2","8","3.30"
"111113","9","9","7","2","6","3.30"
"111148","15","15","13","2","9","3.30"
"111219","15","15","10","5","10","3.30"
"111324","11","11","11","0","7","3.30"
"111644","11","11","10","1","7","3.30"
"111801","14","14","12","2","6","3.30"
"111832","14","14","11","3","6","3.30"
"111848","22","22","19","3","15","3.30"
"111990","12","12","12","0","7","3.30"
"112143","23","23","18","5","13","3.30"
"112169","11","11","11","0","8","3.30"
"112196","14","14","11","3","6","3.30"
"112228","14","14","11","3","7","3.30"
"112329","12","12","11","1","7","3.30"
"112473","10","10","9","1","6","3.30"
"112501","16","16","14","2","6","3.30"
"112531","15","15","12","3","6","3.30"
"112644","9","9","7","2","6","3.30"
"112871","12","12","10","2","6","3.30"
"112925","11","11","10","1","7","3.30"
"112946","12","12","12","0","8","3.30"
"113058","16","16","11","5","7","3.30"
"113676","15","15","15","0","9","3.30"
"113690","17","17","11","6","7","3.30"
"113810","12","12","9","3","6","3.30"
"113938","14","14","12","2","6","3.30"
"114191","10","10","10","0","6","3.30"
"114459","8","8","7","1","7","3.30"
"114677","21","21","20","1","17","3.30"
"114705","12","12","11","1","7","3.30"
"115297","13","13","12","1","8","3.30"
"115462","17","17","16","1","10","3.30"
"115517","16","16","16","0","8","3.30"
"115646","15","15","13","2","10","3.30"
"115860","10","10","9","1","6","3.30"
"115911","9","9","9","0","7","3.30"
"115914","10","10","10","0","7","3.30"
"116034","11","11","11","0","8","3.30"
"116045","17","17","14","3","9","3.30"
"116095","15","15","13","2","7","3.30"
"116192","17","17","14","3","8","3.30"
"116333","9","9","9","0","8","3.30"
"116362","10","10","9","1","9","3.30"
"116486","15","15","11","4","8","3.30"
"116491","12","12","11","1","7","3.30"
"116708","12","12","11","1","7","3.30"
"116807","16","16","14","2","12","3.30"
"116824","15","15","13","2","6","3.30"
"117037","11","11","8","3","6","3.30"
"117097","13","13","11","2","8","3.30"
"117143","21","20","21","0","12","3.30"
"117220","13","13","12","1","6","3.30"
"117291","11","11","8","3","6","3.30"
"117556","12","12","10","2","8","3.30"
"100035","14","14","12","2","8","3.29"
"100106","11","11","10","1","7","3.29"
"100216","15","15","14","1","9","3.29"
"101251","16","16","15","1","13","3.29"
"101417","14","14","14","0","10","3.29"
"101450","21","21","21","0","9","3.29"
"101502","13","13","13","0","9","3.29"
"101593","12","12","11","1","8","3.29"
"101597","16","16","14","2","8","3.29"
"101716","16","16","13","3","9","3.29"
"101775","20","20","18","2","12","3.29"
"101811","11","11","11","0","9","3.29"
"102045","13","13","11","2","9","3.29"
"102249","15","15","15","0","12","3.29"
"102259","13","13","12","1","10","3.29"
"102260","13","13","11","2","10","3.29"
"102277","14","14","12","2","10","3.29"
"102518","17","17","15","2","11","3.29"
"102819","16","16","16","0","13","3.29"
"102884","17","17","16","1","13","3.29"
"102904","15","15","12","3","7","3.29"
"103031","12","12","10","2","7","3.29"
"103060","12","12","12","0","10","3.29"
"103308","15","15","13","2","8","3.29"
"103750","13","13","13","0","8","3.29"
"103790","15","15","14","1","12","3.29"
"104011","17","17","16","1","13","3.29"
"104053","18","18","14","4","11","3.29"
"104482","13","13","11","2","8","3.29"
"104794","15","15","15","0","11","3.29"
"104852","9","9","9","0","7","3.29"
"105020","17","16","16","1","11","3.29"
"105115","19","19","18","1","15","3.29"
"105129","14","14","13","1","7","3.29"
"105182","18","18","17","1","8","3.29"
"105211","15","15","12","3","9","3.29"
"105280","13","13","13","0","10","3.29"
"105322","17","17","16","1","11","3.29"
"105698","11","11","10","1","7","3.29"
"105845","16","16","15","1","11","3.29"
"106041","15","15","13","2","12","3.29"
"106082","11","11","8","3","7","3.29"
"106187","14","14","14","0","10","3.29"
"106208","14","14","14","0","11","3.29"
"106211","15","15","15","0","11","3.29"
"106454","14","14","13","1","9","3.29"
"106521","11","11","11","0","9","3.29"
"106554","13","13","13","0","11","3.29"
"106566","15","15","11","4","8","3.29"
"106790","13","13","13","0","8","3.29"
"106809","15","15","13","2","9","3.29"
"106875","15","15","15","0","10","3.29"
"106992","13","13","12","1","10","3.29"
"107006","11","11","11","0","8","3.29"
"107232","16","16","16","0","12","3.29"
"107235","11","11","9","2","9","3.29"
"107322","13","13","10","3","7","3.29"
"107485","15","15","13","2","7","3.29"
"107536","16","16","16","0","11","3.29"
"107565","22","22","19","3","13","3.29"
"107667","14","14","13","1","10","3.29"
"107832","19","19","19","0","14","3.29"
"108091","12","12","12","0","9","3.29"
"108094","12","12","12","0","8","3.29"
"108226","15","15","13","2","9","3.29"
"108293","14","14","12","2","8","3.29"
"108446","14","14","13","1","9","3.29"
"108512","13","13","13","0","11","3.29"
"108519","12","12","11","1","9","3.29"
"108578","12","12","12","0","8","3.29"
"108836","17","17","17","0","13","3.29"
"108853","19","19","19","0","13","3.29"
"109011","14","14","12","2","10","3.29"
"109177","12","12","11","1","8","3.29"
"109276","11","11","10","1","8","3.29"
"109356","17","17","17","0","14","3.29"
"109426","17","17","15","2","10","3.29"
"109502","15","15","13","2","10","3.29"
"109544","13","13","12","1","9","3.29"
"109601","11","11","11","0","9","3.29"
"109681","14","14","14","0","11","3.29"
"109758","22","22","22","0","15","3.29"
"109816","18","18","16","2","15","3.29"
"109863","21","20","17","4","10","3.29"
"109921","15","15","13","2","8","3.29"
"110003","14","14","12","2","8","3.29"
"110046","14","14","14","0","9","3.29"
"110178","14","14","13","1","9","3.29"
"110230","15","15","13","2","9","3.29"
"110298","14","14","12","2","9","3.29"
"110374","12","12","11","1","8","3.29"
"110491","14","14","13","1","8","3.29"
"110593","19","19","15","4","11","3.29"
"110677","15","15","14","1","9","3.29"
"110766","16","16","13","3","9","3.29"
"110985","17","17","15","2","10","3.29"
"111046","16","16","15","1","11","3.29"
"111136","15","15","15","0","13","3.29"
"111158","19","19","18","1","13","3.29"
"111166","15","15","13","2","8","3.29"
"111255","15","15","14","1","12","3.29"
"111555","16","16","15","1","15","3.29"
"111593","17","17","16","1","11","3.29"
"111699","15","15","12","3","11","3.29"
"111994","13","13","13","0","9","3.29"
"112279","14","14","14","0","10","3.29"
"112439","16","16","14","2","8","3.29"
"112566","19","19","15","4","11","3.29"
"112767","19","19","17","2","14","3.29"
"113182","18","18","14","4","7","3.29"
"113286","14","14","12","2","9","3.29"
"113435","13","13","12","1","7","3.29"
"113467","22","22","18","4","13","3.29"
"113486","19","19","15","4","11","3.29"
"113526","11","11","11","0","7","3.29"
"113779","18","18","16","2","12","3.29"
"113783","14","14","13","1","10","3.29"
"113824","13","12","12","1","9","3.29"
"113855","14","14","12","2","7","3.29"
"113907","13","13","12","1","9","3.29"
"113924","12","12","11","1","8","3.29"
"113987","15","15","15","0","12","3.29"
"114223","15","15","15","0","9","3.29"
"114230","15","15","14","1","11","3.29"
"114289","15","15","14","1","9","3.29"
"114292","15","15","13","2","11","3.29"
"114401","13","13","12","1","10","3.29"
"114664","14","14","12","2","8","3.29"
"114704","10","10","10","0","7","3.29"
"115156","10","10","9","1","7","3.29"
"115412","15","15","13","2","8","3.29"
"115457","16","16","14","2","9","3.29"
"115564","15","15","13","2","7","3.29"
"115689","17","17","15","2","10","3.29"
"116291","13","13","11","2","7","3.29"
"116318","19","19","18","1","13","3.29"
"116361","15","15","15","0","11","3.29"
"116530","13","13","11","2","7","3.29"
"116620","17","17","15","2","14","3.29"
"117105","19","19","17","2","11","3.29"
"117283","16","16","15","1","11","3.29"
"117322","20","20","18","2","14","3.29"
"117572","17","17","17","0","13","3.29"
"117582","20","20","18","2","13","3.29"
"100407","13","13","13","0","10","3.28"
"100754","21","21","19","2","13","3.28"
"100796","18","18","15","3","13","3.28"
"101412","14","14","12","2","10","3.28"
"101465","12","12","10","2","9","3.28"
"101864","16","16","13","3","10","3.28"
"102288","13","13","13","0","9","3.28"
"102297","19","19","18","1","12","3.28"
"102591","16","16","14","2","10","3.28"
"102753","20","20","20","0","15","3.28"
"102862","15","15","14","1","9","3.28"
"103156","18","18","16","2","10","3.28"
"103170","17","17","16","1","11","3.28"
"103335","20","20","16","4","12","3.28"
"103405","14","14","14","0","11","3.28"
"103638","18","18","18","0","17","3.28"
"104414","19","19","16","3","13","3.28"
"104586","16","16","13","3","9","3.28"
"105196","10","10","10","0","6","3.28"
"105461","13","13","10","3","9","3.28"
"105546","14","14","13","1","9","3.28"
"105965","21","21","18","3","13","3.28"
"106001","14","14","13","1","8","3.28"
"106225","21","21","17","4","12","3.28"
"106405","12","12","11","1","8","3.28"
"106470","13","13","12","1","10","3.28"
"106736","15","15","13","2","12","3.28"
"107670","15","15","15","0","11","3.28"
"109155","9","9","7","2","7","3.28"
"109242","15","14","14","1","12","3.28"
"109533","19","19","19","0","16","3.28"
"109798","16","16","15","1","13","3.28"
"109969","16","16","13","3","10","3.28"
"110068","10","10","10","0","9","3.28"
"110202","18","18","17","1","11","3.28"
"111414","15","15","14","1","10","3.28"
"112004","19","19","16","3","13","3.28"
"112645","17","17","17","0","10","3.28"
"112674","23","23","23","0","13","3.28"
"112676","13","13","12","1","10","3.28"
"113080","15","15","15","0","13","3.28"
"113437","12","12","11","1","8","3.28"
"113998","17","17","17","0","12","3.28"
"114072","16","16","14","2","12","3.28"
"114378","16","16","15","1","12","3.28"
"114497","15","15","14","1","10","3.28"
"114563","11","11","10","1","6","3.28"
"114581","17","17","16","1","11","3.28"
"114699","15","15","15","0","13","3.28"
"114761","14","14","13","1","8","3.28"
"114956","16","16","15","1","11","3.28"
"114978","18","18","16","2","12","3.28"
"115047","12","12","12","0","10","3.28"
"115089","15","15","15","0","9","3.28"
"115790","15","15","12","3","8","3.28"
"116448","18","18","15","3","13","3.28"
"117093","20","20","20","0","14","3.28"
"117408","16","15","15","1","10","3.28"
"117445","19","19","18","1","14","3.28"
"117461","22","22","19","3","13","3.28"
"100269","17","17","15","2","10","3.27"
"100434","17","17","14","3","8","3.27"
"100639","12","12","12","0","8","3.27"
"101264","21","21","19","2","14","3.27"
"101659","13","13","12","1","7","3.27"
"102086","10","10","9","1","7","3.27"
"102314","21","21","19","2","13","3.27"
"103287","16","16","16","0","10","3.27"
"103321","16","16","14","2","9","3.27"
"105214","18","18","16","2","11","3.27"
"105529","11","11","11","0","8","3.27"
"106029","15","15","13","2","9","3.27"
"106222","14","14","13","1","8","3.27"
"106235","15","15","13","2","7","3.27"
"106835","14","14","11","3","9","3.27"
"107083","15","15","15","0","12","3.27"
"108412","15","15","14","1","12","3.27"
"108664","11","11","11","0","9","3.27"
"110039","17","17","15","2","9","3.27"
"110192","11","11","10","1","7","3.27"
"110738","16","16","15","1","7","3.27"
"111232","16","16","16","0","12","3.27"
"111877","20","20","17","3","10","3.27"
"112450","19","19","17","2","15","3.27"
"112681","12","12","11","1","8","3.27"
"112829","13","13","12","1","8","3.27"
"113010","15","15","15","0","9","3.27"
"113409","11","11","10","1","7","3.27"
"113595","13","13","12","1","10","3.27"
"113784","10","10","9","1","8","3.27"
"114673","12","12","12","0","9","3.27"
"115602","11","11","11","0","10","3.27"
"116548","16","16","15","1","11","3.27"
"116889","10","10","10","0","8","3.27"
"117496","18","18","18","0","11","3.27"
"117598","23","23","21","2","14","3.27"
"102048","14","14","14","0","11","3.26"
"102405","16","16","13","3","12","3.26"
"102447","13","13","12","1","11","3.26"
"102485","20","20","19","1","13","3.26"
"102643","15","15","15","0","11","3.26"
"102808","16","16","14","2","10","3.26"
"104137","19","19","19","0","17","3.26"
"104270","17","17","16","1","12","3.26"
"104645","17","17","16","1","13","3.26"
"104936","18","18","16","2","12","3.26"
"106582","30","30","29","1","27","3.26"
"106914","16","16","15","1","11","3.26"
"107220","16","16","15","1","13","3.26"
"107343","18","18","15","3","13","3.26"
"107399","17","17","14","3","11","3.26"
"111411","13","13","12","1","10","3.26"
"111846","17","17","17","0","13","3.26"
"112263","16","16","16","0","12","3.26"
"112976","15","15","14","1","10","3.26"
"113729","14","14","12","2","12","3.26"
"113770","17","17","17","0","11","3.26"
"113902","15","15","15","0","11","3.26"
"114085","18","18","17","1","12","3.26"
"114494","18","18","15","3","10","3.26"
"114559","17","17","16","1","12","3.26"
"114681","24","24","20","4","13","3.26"
"114999","18","18","17","1","12","3.26"
"115415","16","16","16","0","14","3.26"
"115633","20","20","15","5","10","3.26"
"115668","16","16","16","0","12","3.26"
"100004","10","10","10","0","7","3.25"
"100011","10","10","10","0","6","3.25"
"100074","19","19","16","3","14","3.25"
"100125","9","9","8","1","7","3.25"
"100205","13","13","10","3","5","3.25"
"100231","13","13","11","2","7","3.25"
"100248","10","10","9","1","5","3.25"
"100252","15","15","14","1","12","3.25"
"100319","23","23","19","4","12","3.25"
"100346","8","8","7","1","6","3.25"
"100535","16","16","15","1","11","3.25"
"100536","18","18","17","1","9","3.25"
"100547","15","15","14","1","8","3.25"
"100612","13","13","11","2","6","3.25"
"100634","14","14","13","1","9","3.25"
"100761","14","14","11","3","7","3.25"
"100836","14","14","10","4","7","3.25"
"100858","14","14","12","2","9","3.25"
"100877","10","10","10","0","7","3.25"
"100897","11","11","10","1","4","3.25"
"100927","14","14","11","3","9","3.25"
"100949","16","16","16","0","12","3.25"
"101109","14","14","13","1","6","3.25"
"101173","15","15","13","2","8","3.25"
"101189","12","12","12","0","8","3.25"
"101193","10","10","9","1","7","3.25"
"101245","12","12","11","1","8","3.25"
"101315","9","9","9","0","7","3.25"
"101329","14","14","13","1","10","3.25"
"101378","12","12","9","3","7","3.25"
"101480","10","9","10","0","5","3.25"
"101487","13","13","11","2","7","3.25"
"101510","12","12","12","0","9","3.25"
"101513","19","19","16","3","12","3.25"
"101549","20","20","19","1","12","3.25"
"101596","16","16","16","0","9","3.25"
"101600","18","17","17","1","10","3.25"
"101622","8","8","7","1","5","3.25"
"101697","20","20","15","5","10","3.25"
"101702","9","9","9","0","7","3.25"
"101785","17","17","13","4","9","3.25"
"101841","11","11","9","2","5","3.25"
"101863","15","15","15","0","11","3.25"
"101866","13","13","11","2","10","3.25"
"101925","22","22","20","2","13","3.25"
"101977","14","14","12","2","5","3.25"
"102011","11","11","10","1","7","3.25"
"102064","12","12","10","2","5","3.25"
"102098","10","10","7","3","4","3.25"
"102105","15","15","12","3","8","3.25"
"102185","16","16","15","1","11","3.25"
"102236","18","18","13","5","9","3.25"
"102282","11","11","11","0","9","3.25"
"102349","18","18","18","0","13","3.25"
"102373","20","20","20","0","12","3.25"
"102460","12","12","9","3","7","3.25"
"102483","13","13","11","2","9","3.25"
"102506","8","8","8","0","7","3.25"
"102529","15","15","14","1","12","3.25"
"102573","12","12","11","1","6","3.25"
"102593","11","11","9","2","4","3.25"
"102668","9","9","8","1","7","3.25"
"102811","13","13","12","1","10","3.25"
"102830","9","9","8","1","7","3.25"
"102916","11","11","10","1","8","3.25"
"102925","20","20","18","2","12","3.25"
"102928","18","18","16","2","9","3.25"
"102932","19","19","16","3","10","3.25"
"102963","14","14","14","0","13","3.25"
"103079","10","10","10","0","8","3.25"
"103151","11","11","10","1","7","3.25"
"103162","15","15","14","1","9","3.25"
"103182","12","12","10","2","6","3.25"
"103234","8","8","8","0","4","3.25"
"103279","15","15","13","2","10","3.25"
"103351","14","14","12","2","8","3.25"
"103384","13","13","10","3","6","3.25"
"103385","10","10","8","2","5","3.25"
"103498","12","12","11","1","5","3.25"
"103513","10","10","8","2","5","3.25"
"103528","15","15","12","3","8","3.25"
"103531","8","8","7","1","5","3.25"
"103552","16","16","14","2","8","3.25"
"103597","12","12","12","0","9","3.25"
"103636","15","15","15","0","12","3.25"
"103703","9","9","8","1","4","3.25"
"103729","8","8","6","2","6","3.25"
"103738","15","15","14","1","8","3.25"
"103827","12","12","12","0","10","3.25"
"103831","15","15","11","4","9","3.25"
"103849","12","12","11","1","6","3.25"
"103905","14","14","13","1","6","3.25"
"103909","15","15","13","2","4","3.25"
"103949","13","13","12","1","4","3.25"
"103980","9","9","8","1","5","3.25"
"103991","17","17","17","0","10","3.25"
"104027","8","8","7","1","4","3.25"
"104046","7","7","7","0","3","3.25"
"104071","15","15","14","1","9","3.25"
"104207","14","14","12","2","8","3.25"
"104238","15","15","12","3","8","3.25"
"104359","16","16","15","1","12","3.25"
"104382","11","11","11","0","7","3.25"
"104387","9","9","7","2","5","3.25"
"104408","14","14","14","0","9","3.25"
"104434","18","18","18","0","13","3.25"
"104458","15","15","13","2","9","3.25"
"104487","13","13","12","1","5","3.25"
"104509","10","10","8","2","5","3.25"
"104524","14","14","11","3","5","3.25"
"104654","14","14","13","1","7","3.25"
"104742","13","13","13","0","9","3.25"
"104743","12","12","11","1","6","3.25"
"104765","22","22","20","2","14","3.25"
"104773","24","24","23","1","19","3.25"
"104802","16","16","14","2","8","3.25"
"104840","15","15","11","4","7","3.25"
"104857","13","13","11","2","10","3.25"
"105001","13","13","13","0","8","3.25"
"105027","16","16","15","1","12","3.25"
"105226","9","9","6","3","5","3.25"
"105253","12","12","12","0","9","3.25"
"105282","12","12","11","1","4","3.25"
"105306","11","11","10","1","7","3.25"
"105318","14","14","12","2","10","3.25"
"105432","17","17","15","2","10","3.25"
"105437","25","25","24","1","15","3.25"
"105486","14","14","13","1","6","3.25"
"105493","17","17","15","2","12","3.25"
"105542","13","13","11","2","5","3.25"
"105569","12","12","11","1","6","3.25"
"105625","16","16","13","3","11","3.25"
"105647","14","14","14","0","7","3.25"
"105674","14","14","12","2","9","3.25"
"105687","19","19","17","2","11","3.25"
"105734","13","13","12","1","6","3.25"
"105774","16","16","15","1","8","3.25"
"105829","11","11","10","1","5","3.25"
"105860","14","14","13","1","10","3.25"
"105911","9","9","9","0","3","3.25"
"105932","11","11","10","1","7","3.25"
"106057","7","7","7","0","4","3.25"
"106122","12","12","11","1","10","3.25"
"106296","13","13","12","1","8","3.25"
"106332","13","13","13","0","10","3.25"
"106386","10","10","10","0","5","3.25"
"106416","13","13","13","0","6","3.25"
"106465","19","19","18","1","13","3.25"
"106471","13","13","13","0","11","3.25"
"106497","14","14","14","0","8","3.25"
"106552","15","15","13","2","11","3.25"
"106581","14","14","13","1","10","3.25"
"106585","12","12","11","1","6","3.25"
"106609","20","20","15","5","11","3.25"
"106709","15","15","15","0","11","3.25"
"106779","15","15","11","4","6","3.25"
"106884","14","14","11","3","9","3.25"
"106886","13","13","13","0","8","3.25"
"106896","8","8","8","0","4","3.25"
"106949","11","11","10","1","6","3.25"
"106950","13","13","12","1","10","3.25"
"106957","9","9","8","1","6","3.25"
"107026","9","9","8","1","4","3.25"
"107066","19","19","15","4","11","3.25"
"107099","16","15","15","1","7","3.25"
"107109","15","15","13","2","11","3.25"
"107139","11","11","10","1","7","3.25"
"107159","16","16","15","1","12","3.25"
"107201","11","11","8","3","4","3.25"
"107212","17","17","16","1","15","3.25"
"107280","14","14","12","2","4","3.25"
"107291","20","20","15","5","10","3.25"
"107396","11","11","10","1","4","3.25"
"107487","13","13","12","1","8","3.25"
"107527","11","11","10","1","5","3.25"
"107547","12","12","12","0","7","3.25"
"107554","12","12","11","1","4","3.25"
"107559","17","17","14","3","9","3.25"
"107722","16","16","16","0","12","3.25"
"107725","13","13","13","0","11","3.25"
"107736","10","10","10","0","6","3.25"
"107826","15","15","12","3","9","3.25"
"107861","24","24","20","4","15","3.25"
"107896","10","10","9","1","5","3.25"
"107931","18","18","15","3","8","3.25"
"107966","7","7","7","0","6","3.25"
"107980","7","7","6","1","4","3.25"
"107999","19","19","18","1","10","3.25"
"108032","14","14","12","2","7","3.25"
"108070","19","19","18","1","15","3.25"
"108088","11","11","9","2","4","3.25"
"108093","11","11","10","1","7","3.25"
"108208","12","12","12","0","8","3.25"
"108214","14","14","13","1","9","3.25"
"108217","12","12","11","1","9","3.25"
"108224","13","13","11","2","8","3.25"
"108239","11","11","10","1","7","3.25"
"108268","14","14","12","2","7","3.25"
"108272","13","13","10","3","8","3.25"
"108337","10","10","9","1","5","3.25"
"108347","20","20","18","2","15","3.25"
"108368","15","15","13","2","10","3.25"
"108450","17","17","16","1","9","3.25"
"108500","21","21","19","2","11","3.25"
"108530","10","10","10","0","8","3.25"
"108560","12","12","10","2","8","3.25"
"108577","11","11","10","1","7","3.25"
"108696","12","12","10","2","5","3.25"
"108730","11","11","11","0","7","3.25"
"108733","7","7","7","0","4","3.25"
"108742","13","13","12","1","6","3.25"
"108746","9","9","8","1","6","3.25"
"108772","11","11","10","1","5","3.25"
"108810","13","13","13","0","6","3.25"
"108938","14","14","13","1","8","3.25"
"109156","18","18","17","1","14","3.25"
"109193","11","11","10","1","4","3.25"
"109370","12","12","10","2","8","3.25"
"109519","21","21","16","5","9","3.25"
"109543","11","11","9","2","6","3.25"
"109582","15","15","13","2","8","3.25"
"109622","8","8","8","0","6","3.25"
"109635","10","10","10","0","7","3.25"
"109673","14","14","11","3","5","3.25"
"109686","11","11","8","3","8","3.25"
"109708","11","11","9","2","7","3.25"
"109825","12","12","12","0","9","3.25"
"109833","8","8","7","1","4","3.25"
"109839","10","10","8","2","4","3.25"
"109895","12","12","11","1","9","3.25"
"109918","10","10","10","0","10","3.25"
"109984","11","11","9","2","4","3.25"
"110030","10","10","9","1","3","3.25"
"110032","20","20","17","3","15","3.25"
"110061","9","9","8","1","8","3.25"
"110095","18","18","17","1","12","3.25"
"110106","7","7","7","0","5","3.25"
"110173","11","11","9","2","6","3.25"
"110294","16","16","13","3","8","3.25"
"110303","13","13","9","4","7","3.25"
"110344","12","12","10","2","6","3.25"
"110396","12","12","10","2","8","3.25"
"110420","10","10","10","0","6","3.25"
"110543","7","7","7","0","7","3.25"
"110559","5","5","4","1","4","3.25"
"110576","15","15","14","1","8","3.25"
"110690","11","11","9","2","4","3.25"
"110699","11","11","10","1","9","3.25"
"110912","7","7","6","1","4","3.25"
"110961","12","12","10","2","9","3.25"
"111015","23","23","20","3","14","3.25"
"111098","10","10","7","3","5","3.25"
"111126","14","14","14","0","11","3.25"
"111176","16","16","13","3","8","3.25"
"111218","10","10","8","2","6","3.25"
"111305","16","16","16","0","9","3.25"
"111481","15","15","13","2","7","3.25"
"111485","19","19","19","0","12","3.25"
"111491","18","18","16","2","12","3.25"
"111551","14","14","12","2","10","3.25"
"111559","15","15","14","1","12","3.25"
"111615","15","15","14","1","11","3.25"
"111625","18","18","15","3","6","3.25"
"111670","17","17","15","2","7","3.25"
"111717","10","10","10","0","4","3.25"
"111722","13","13","12","1","5","3.25"
"111740","19","19","15","4","9","3.25"
"111809","10","10","9","1","7","3.25"
"111883","16","16","15","1","12","3.25"
"111959","10","10","10","0","6","3.25"
"111984","9","9","8","1","7","3.25"
"112085","11","11","11","0","7","3.25"
"112257","13","13","11","2","7","3.25"
"112275","14","14","12","2","6","3.25"
"112352","13","13","12","1","7","3.25"
"112400","10","10","10","0","7","3.25"
"112592","13","13","11","2","8","3.25"
"112628","12","12","12","0","9","3.25"
"112658","11","11","11","0","7","3.25"
"112733","19","19","19","0","8","3.25"
"112788","10","10","9","1","8","3.25"
"112797","7","7","7","0","5","3.25"
"112838","16","16","14","2","9","3.25"
"112845","16","16","10","6","8","3.25"
"112934","11","11","10","1","5","3.25"
"113044","13","13","13","0","10","3.25"
"113237","11","11","11","0","8","3.25"
"113325","13","13","7","6","6","3.25"
"113346","11","11","9","2","7","3.25"
"113369","17","17","17","0","10","3.25"
"113397","15","15","10","5","5","3.25"
"113431","17","17","17","0","10","3.25"
"113626","12","12","10","2","7","3.25"
"113719","16","16","14","2","9","3.25"
"113749","8","8","8","0","5","3.25"
"113753","10","10","9","1","5","3.25"
"113775","13","13","11","2","9","3.25"
"113841","15","15","14","1","9","3.25"
"113923","16","16","13","3","6","3.25"
"113951","15","15","14","1","9","3.25"
"114131","6","6","4","2","4","3.25"
"114243","10","10","8","2","5","3.25"
"114411","12","12","10","2","6","3.25"
"114452","10","10","9","1","5","3.25"
"114472","12","12","11","1","8","3.25"
"114478","11","11","10","1","8","3.25"
"114499","9","9","8","1","6","3.25"
"114527","10","10","9","1","7","3.25"
"114569","9","9","8","1","5","3.25"
"114599","11","11","11","0","6","3.25"
"114669","10","10","9","1","7","3.25"
"114723","13","13","13","0","8","3.25"
"114758","14","14","13","1","8","3.25"
"114949","12","12","11","1","8","3.25"
"115016","13","13","12","1","8","3.25"
"115026","11","11","10","1","8","3.25"
"115127","11","11","9","2","4","3.25"
"115135","11","11","9","2","6","3.25"
"115183","13","13","12","1","8","3.25"
"115196","14","14","13","1","12","3.25"
"115210","12","12","10","2","8","3.25"
"115221","11","11","11","0","7","3.25"
"115226","11","11","9","2","4","3.25"
"115229","14","14","13","1","10","3.25"
"115238","11","11","9","2","7","3.25"
"115308","14","14","13","1","9","3.25"
"115388","11","11","9","2","7","3.25"
"115516","11","11","9","2","5","3.25"
"115532","16","16","15","1","7","3.25"
"115534","15","15","12","3","10","3.25"
"115576","19","19","17","2","12","3.25"
"115615","7","7","6","1","5","3.25"
"115707","13","13","12","1","8","3.25"
"115822","13","13","12","1","8","3.25"
"115856","16","16","14","2","7","3.25"
"115930","15","15","14","1","14","3.25"
"115956","11","11","8","3","4","3.25"
"115992","12","12","9","3","6","3.25"
"116015","13","13","13","0","8","3.25"
"116066","11","11","9","2","8","3.25"
"116104","17","17","12","5","11","3.25"
"116106","12","12","11","1","5","3.25"
"116120","11","11","10","1","7","3.25"
"116149","10","10","10","0","6","3.25"
"116212","14","14","12","2","10","3.25"
"116252","9","9","8","1","6","3.25"
"116267","14","14","14","0","12","3.25"
"116305","14","14","12","2","7","3.25"
"116379","15","15","13","2","11","3.25"
"116385","11","11","11","0","7","3.25"
"116406","11","11","10","1","7","3.25"
"116436","14","14","13","1","7","3.25"
"116483","18","18","17","1","12","3.25"
"116510","15","15","10","5","8","3.25"
"116516","13","13","12","1","5","3.25"
"116602","9","9","8","1","7","3.25"
"116650","19","19","19","0","12","3.25"
"116680","12","12","10","2","9","3.25"
"116726","21","21","19","2","14","3.25"
"116736","7","7","5","2","4","3.25"
"116764","12","12","12","0","8","3.25"
"116836","10","10","9","1","5","3.25"
"116872","15","15","14","1","6","3.25"
"116884","21","21","19","2","12","3.25"
"116950","12","12","12","0","8","3.25"
"116985","15","15","14","1","10","3.25"
"117050","9","9","8","1","5","3.25"
"117196","13","13","11","2","6","3.25"
"117228","24","24","21","3","16","3.25"
"117242","13","13","13","0","11","3.25"
"117292","9","9","5","4","4","3.25"
"117308","12","12","11","1","8","3.25"
"117318","18","18","16","2","8","3.25"
"117349","10","10","9","1","7","3.25"
"117429","14","14","13","1","9","3.25"
"117503","14","14","11","3","7","3.25"
"117512","10","10","10","0","10","3.25"
"117619","13","13","8","5","7","3.25"
"100169","16","16","15","1","12","3.24"
"100378","19","19","17","2","14","3.24"
"100648","17","17","15","2","10","3.24"
"100713","19","19","17","2","11","3.24"
"101127","19","19","18","1","12","3.24"
"101456","19","19","16","3","13","3.24"
"101685","10","10","10","0","9","3.24"
"102459","19","19","17","2","15","3.24"
"102461","16","16","15","1","10","3.24"
"103159","14","14","13","1","11","3.24"
"103432","17","17","15","2","10","3.24"
"104106","17","17","16","1","13","3.24"
"104174","20","20","20","0","14","3.24"
"104296","18","18","16","2","13","3.24"
"105811","13","13","12","1","9","3.24"
"106175","14","14","14","0","10","3.24"
"106192","18","18","16","2","13","3.24"
"106440","21","21","19","2","15","3.24"
"106808","14","14","13","1","9","3.24"
"106887","17","17","14","3","10","3.24"
"108136","16","16","16","0","10","3.24"
"108532","15","15","14","1","10","3.24"
"109771","20","20","18","2","15","3.24"
"110001","18","18","16","2","12","3.24"
"110617","14","14","13","1","9","3.24"
"111027","20","20","16","4","11","3.24"
"111241","20","20","17","3","10","3.24"
"111332","22","22","21","1","15","3.24"
"112409","20","20","19","1","12","3.24"
"113041","13","13","13","0","10","3.24"
"113189","19","19","17","2","13","3.24"
"113524","17","17","17","0","13","3.24"
"100014","16","16","14","2","8","3.23"
"100112","19","19","18","1","10","3.23"
"100725","21","21","20","1","17","3.23"
"100778","16","16","14","2","13","3.23"
"101168","15","15","13","2","10","3.23"
"101577","13","13","13","0","10","3.23"
"101818","14","14","12","2","9","3.23"
"102067","20","20","19","1","14","3.23"
"102130","14","14","13","1","11","3.23"
"102208","13","13","12","1","8","3.23"
"102276","17","17","15","2","10","3.23"
"102745","12","12","11","1","9","3.23"
"102913","16","16","14","2","10","3.23"
"103772","15","15","13","2","10","3.23"
"104970","20","20","20","0","12","3.23"
"105101","15","15","14","1","11","3.23"
"105474","17","17","13","4","9","3.23"
"106699","16","16","11","5","10","3.23"
"106923","16","16","14","2","9","3.23"
"108371","17","17","15","2","8","3.23"
"109910","15","15","13","2","8","3.23"
"110005","19","18","19","0","14","3.23"
"110316","18","18","16","2","9","3.23"
"110388","20","20","17","3","14","3.23"
"110513","18","18","17","1","11","3.23"
"110596","16","16","14","2","10","3.23"
"110866","22","22","20","2","14","3.23"
"111850","27","27","24","3","20","3.23"
"112548","19","19","18","1","13","3.23"
"112598","12","12","11","1","8","3.23"
"112992","14","14","14","0","9","3.23"
"113212","13","13","11","2","9","3.23"
"113266","17","17","17","0","11","3.23"
"113481","13","13","12","1","11","3.23"
"113780","16","16","14","2","9","3.23"
"115096","13","13","12","1","9","3.23"
"115449","12","12","12","0","9","3.23"
"117132","11","11","10","1","8","3.23"
"117522","19","19","17","2","12","3.23"
"100185","15","15","14","1","13","3.22"
"100443","13","13","12","1","9","3.22"
"100554","11","11","9","2","5","3.22"
"100933","18","18","17","1","17","3.22"
"101028","17","17","16","1","12","3.22"
"102389","19","19","17","2","13","3.22"
"102415","17","17","13","4","9","3.22"
"102797","15","15","14","1","9","3.22"
"102943","20","20","17","3","13","3.22"
"103061","17","17","15","2","11","3.22"
"103245","19","19","18","1","12","3.22"
"103284","15","15","11","4","6","3.22"
"103574","25","25","21","4","15","3.22"
"103605","14","14","13","1","11","3.22"
"103677","19","19","17","2","14","3.22"
"103882","20","20","17","3","9","3.22"
"103890","15","15","13","2","9","3.22"
"104268","18","18","18","0","11","3.22"
"105082","16","16","13","3","10","3.22"
"105539","16","16","16","0","9","3.22"
"105736","13","13","12","1","8","3.22"
"105848","16","16","13","3","10","3.22"
"106176","10","10","10","0","7","3.22"
"107106","19","19","19","0","13","3.22"
"107135","19","19","18","1","12","3.22"
"107461","12","12","11","1","8","3.22"
"107523","9","9","8","1","5","3.22"
"107638","19","19","17","2","14","3.22"
"107710","11","11","9","2","8","3.22"
"107824","21","21","19","2","18","3.22"
"107865","16","16","14","2","10","3.22"
"107878","22","22","22","0","16","3.22"
"108246","14","14","11","3","11","3.22"
"108534","18","18","17","1","13","3.22"
"108611","19","19","17","2","14","3.22"
"108793","18","18","14","4","10","3.22"
"108811","14","14","11","3","7","3.22"
"109143","16","16","14","2","11","3.22"
"109204","20","20","20","0","13","3.22"
"109231","14","14","14","0","9","3.22"
"109627","19","19","18","1","13","3.22"
"109858","19","19","18","1","11","3.22"
"109956","12","12","12","0","9","3.22"
"110163","16","16","15","1","13","3.22"
"110251","15","15","12","3","9","3.22"
"110334","13","13","13","0","11","3.22"
"110451","19","19","17","2","13","3.22"
"110583","16","16","16","0","9","3.22"
"110679","12","12","12","0","8","3.22"
"110755","15","15","14","1","10","3.22"
"110772","10","10","8","2","5","3.22"
"110852","7","7","7","0","5","3.22"
"110948","17","17","12","5","8","3.22"
"110986","20","20","18","2","14","3.22"
"111413","18","18","16","2","11","3.22"
"111439","12","12","10","2","8","3.22"
"111649","16","16","13","3","10","3.22"
"111741","16","16","14","2","8","3.22"
"112111","12","12","9","3","5","3.22"
"112346","20","19","19","1","12","3.22"
"112356","13","13","11","2","8","3.22"
"112599","13","13","10","3","6","3.22"
"112738","14","14","12","2","10","3.22"
"113474","14","14","13","1","10","3.22"
"114281","18","18","16","2","14","3.22"
"114421","16","16","16","0","10","3.22"
"114725","13","13","12","1","9","3.22"
"115019","23","23","20","3","15","3.22"
"115203","16","16","12","4","8","3.22"
"115322","13","13","11","2","9","3.22"
"115346","21","20","19","2","15","3.22"
"115454","21","21","21","0","13","3.22"
"115844","12","12","11","1","10","3.22"
"116009","15","15","15","0","12","3.22"
"116102","13","13","12","1","10","3.22"
"116238","12","12","10","2","6","3.22"
"116260","28","28","27","1","25","3.22"
"116636","17","16","14","3","12","3.22"
"116661","14","14","14","0","11","3.22"
"116711","16","16","13","3","11","3.22"
"116861","20","20","17","3","14","3.22"
"116874","10","10","9","1","5","3.22"
"116983","19","19","18","1","12","3.22"
"100181","12","12","12","0","8","3.21"
"100260","16","16","16","0","9","3.21"
"100344","15","15","13","2","10","3.21"
"100484","10","10","9","1","7","3.21"
"100515","14","14","12","2","10","3.21"
"100640","24","24","22","2","14","3.21"
"100721","16","16","12","4","9","3.21"
"100743","12","12","11","1","11","3.21"
"100755","19","19","18","1","12","3.21"
"101068","14","14","13","1","12","3.21"
"101175","15","15","13","2","12","3.21"
"101469","16","16","15","1","10","3.21"
"101505","14","14","14","0","9","3.21"
"101634","14","14","13","1","9","3.21"
"101663","21","21","18","3","11","3.21"
"101820","17","17","16","1","14","3.21"
"101858","16","16","16","0","9","3.21"
"102171","17","17","15","2","8","3.21"
"102240","14","14","14","0","8","3.21"
"102372","19","19","15","4","12","3.21"
"102404","9","9","8","1","7","3.21"
"102580","12","12","11","1","8","3.21"
"102687","13","13","13","0","11","3.21"
"102733","12","12","11","1","8","3.21"
"103026","12","12","10","2","9","3.21"
"103051","12","12","12","0","9","3.21"
"103087","12","12","12","0","11","3.21"
"103225","19","19","18","1","12","3.21"
"103227","16","16","13","3","11","3.21"
"103467","21","21","18","3","13","3.21"
"103591","18","18","16","2","9","3.21"
"103709","20","20","18","2","12","3.21"
"103715","14","14","13","1","9","3.21"
"103824","14","14","14","0","12","3.21"
"103859","15","15","15","0","11","3.21"
"103879","19","19","18","1","11","3.21"
"103938","17","17","15","2","12","3.21"
"104462","16","16","14","2","8","3.21"
"104837","18","18","17","1","14","3.21"
"105149","16","16","14","2","10","3.21"
"105197","15","15","14","1","10","3.21"
"105271","19","19","18","1","13","3.21"
"105498","18","18","16","2","11","3.21"
"105663","12","12","12","0","8","3.21"
"105669","14","14","14","0","13","3.21"
"105897","14","14","14","0","11","3.21"
"105900","16","16","15","1","8","3.21"
"106036","12","12","12","0","10","3.21"
"106135","12","12","10","2","8","3.21"
"106453","15","15","12","3","9","3.21"
"106466","16","16","14","2","11","3.21"
"106724","16","16","14","2","12","3.21"
"106959","22","22","19","3","12","3.21"
"107129","17","17","15","2","11","3.21"
"107269","16","16","15","1","10","3.21"
"107278","16","16","13","3","9","3.21"
"107509","12","12","12","0","9","3.21"
"107603","14","14","13","1","10","3.21"
"107612","14","14","11","3","8","3.21"
"107615","10","10","9","1","7","3.21"
"108065","20","20","18","2","13","3.21"
"108085","18","18","14","4","12","3.21"
"108238","14","14","14","0","11","3.21"
"108518","14","14","13","1","9","3.21"
"108601","12","12","11","1","9","3.21"
"108626","17","17","15","2","11","3.21"
"108718","10","10","10","0","9","3.21"
"108992","14","14","14","0","10","3.21"
"109038","10","10","10","0","8","3.21"
"109232","15","15","10","5","9","3.21"
"109615","14","14","10","4","8","3.21"
"109675","16","16","16","0","10","3.21"
"109812","16","16","14","2","12","3.21"
"109826","19","19","18","1","15","3.21"
"109993","14","14","11","3","9","3.21"
"110009","17","17","16","1","13","3.21"
"110128","14","14","13","1","8","3.21"
"110238","14","14","12","2","7","3.21"
"110363","14","14","11","3","11","3.21"
"110514","12","12","10","2","8","3.21"
"110587","20","20","19","1","12","3.21"
"110750","12","12","10","2","9","3.21"
"110762","20","20","18","2","14","3.21"
"110784","18","18","17","1","11","3.21"
"111099","14","13","14","0","12","3.21"
"111333","23","23","19","4","13","3.21"
"111391","12","12","11","1","9","3.21"
"111480","15","15","14","1","12","3.21"
"111586","20","20","17","3","14","3.21"
"111742","15","15","13","2","8","3.21"
"111842","14","14","14","0","10","3.21"
"112041","17","17","16","1","10","3.21"
"112065","17","17","15","2","10","3.21"
"112236","18","18","17","1","11","3.21"
"112403","13","13","12","1","10","3.21"
"112410","13","13","11","2","10","3.21"
"112434","16","16","15","1","11","3.21"
"112513","16","15","12","4","8","3.21"
"112705","17","17","16","1","13","3.21"
"112725","13","13","12","1","10","3.21"
"112939","16","16","14","2","9","3.21"
"112979","18","18","18","0","13","3.21"
"112997","18","18","16","2","12","3.21"
"113051","17","17","17","0","10","3.21"
"113197","12","12","10","2","9","3.21"
"113381","17","17","17","0","12","3.21"
"113541","13","13","12","1","10","3.21"
"114070","13","13","11","2","8","3.21"
"114113","16","16","15","1","12","3.21"
"114278","15","15","12","3","8","3.21"
"114330","18","18","16","2","9","3.21"
"114341","14","14","12","2","10","3.21"
"114403","13","13","12","1","8","3.21"
"114449","14","14","13","1","7","3.21"
"114545","16","16","15","1","9","3.21"
"114615","14","14","11","3","8","3.21"
"114639","16","16","14","2","9","3.21"
"114767","18","18","16","2","11","3.21"
"114802","11","11","10","1","8","3.21"
"114820","15","15","12","3","9","3.21"
"114870","13","13","12","1","10","3.21"
"115431","12","12","11","1","9","3.21"
"115471","15","15","12","3","9","3.21"
"115651","18","18","14","4","9","3.21"
"115683","11","11","11","0","10","3.21"
"115963","17","17","15","2","14","3.21"
"116042","17","17","15","2","10","3.21"
"116134","13","13","13","0","10","3.21"
"116338","22","22","18","4","11","3.21"
"116368","19","19","17","2","11","3.21"
"116506","12","12","12","0","9","3.21"
"116575","13","13","13","0","11","3.21"
"116595","16","16","16","0","10","3.21"
"116743","14","14","14","0","12","3.21"
"116772","16","16","16","0","11","3.21"
"116919","13","13","13","0","11","3.21"
"117026","18","18","17","1","14","3.21"
"117108","14","14","13","1","9","3.21"
"117120","16","16","15","1","10","3.21"
"117183","17","17","15","2","13","3.21"
"117229","21","20","17","4","11","3.21"
"117304","19","19","18","1","12","3.21"
"117372","15","15","14","1","10","3.21"
"117457","16","16","14","2","10","3.21"
"100064","12","12","11","1","6","3.20"
"100131","11","11","11","0","11","3.20"
"100230","10","10","9","1","5","3.20"
"100351","12","12","12","0","8","3.20"
"100486","15","15","13","2","12","3.20"
"100501","8","8","6","2","6","3.20"
"100616","11","11","8","3","6","3.20"
"100747","14","14","13","1","8","3.20"
"100850","12","12","12","0","5","3.20"
"101076","9","9","8","1","6","3.20"
"101106","13","13","12","1","7","3.20"
"101353","10","10","8","2","5","3.20"
"101508","14","14","13","1","9","3.20"
"101518","9","9","9","0","7","3.20"
"101550","11","11","11","0","8","3.20"
"101611","16","16","12","4","9","3.20"
"101710","11","11","11","0","9","3.20"
"101733","14","14","13","1","7","3.20"
"102016","15","15","15","0","11","3.20"
"102081","14","14","9","5","7","3.20"
"102107","14","14","13","1","8","3.20"
"102148","16","16","14","2","9","3.20"
"102263","21","21","17","4","11","3.20"
"102283","11","11","10","1","5","3.20"
"102286","13","13","10","3","5","3.20"
"102303","10","10","9","1","6","3.20"
"102487","10","10","9","1","5","3.20"
"102583","13","13","11","2","9","3.20"
"102690","11","11","11","0","8","3.20"
"102774","11","11","9","2","8","3.20"
"102782","17","17","15","2","10","3.20"
"102883","15","15","14","1","9","3.20"
"102978","16","16","12","4","9","3.20"
"103075","16","16","14","2","9","3.20"
"103092","13","13","11","2","7","3.20"
"103130","19","19","17","2","12","3.20"
"103185","9","9","7","2","6","3.20"
"103283","5","5","5","0","5","3.20"
"103303","15","15","13","2","8","3.20"
"103559","12","12","12","0","11","3.20"
"103563","7","7","7","0","6","3.20"
"103587","13","13","9","4","8","3.20"
"103613","13","13","12","1","10","3.20"
"103647","15","15","13","2","9","3.20"
"103675","17","16","17","0","10","3.20"
"103756","11","11","11","0","7","3.20"
"103757","17","17","14","3","9","3.20"
"103789","14","14","13","1","7","3.20"
"104058","11","11","8","3","5","3.20"
"104412","14","14","12","2","8","3.20"
"104423","19","19","17","2","11","3.20"
"104566","15","15","14","1","10","3.20"
"104688","11","11","9","2","6","3.20"
"104829","15","15","14","1","7","3.20"
"105002","19","19","17","2","10","3.20"
"105013","12","12","11","1","7","3.20"
"105169","23","23","20","3","14","3.20"
"105215","15","15","14","1","9","3.20"
"105342","10","10","9","1","5","3.20"
"105415","16","16","15","1","9","3.20"
"105506","15","15","15","0","13","3.20"
"105549","10","10","10","0","6","3.20"
"105747","14","14","13","1","7","3.20"
"105889","15","15","15","0","7","3.20"
"105913","14","14","13","1","10","3.20"
"105946","19","19","16","3","7","3.20"
"105997","12","12","11","1","7","3.20"
"106073","14","14","11","3","9","3.20"
"106093","8","8","7","1","5","3.20"
"106143","14","14","11","3","7","3.20"
"106197","12","12","10","2","7","3.20"
"106354","13","13","13","0","12","3.20"
"106395","8","8","7","1","6","3.20"
"106462","13","13","12","1","8","3.20"
"106530","11","11","10","1","9","3.20"
"106586","10","10","8","2","7","3.20"
"106794","10","10","8","2","6","3.20"
"106930","12","12","11","1","7","3.20"
"106953","12","12","10","2","10","3.20"
"106963","20","20","17","3","15","3.20"
"107055","17","17","17","0","9","3.20"
"107082","14","14","12","2","9","3.20"
"107088","16","16","12","4","7","3.20"
"107120","19","19","18","1","10","3.20"
"107207","10","10","10","0","8","3.20"
"107210","10","10","10","0","6","3.20"
"107282","10","10","10","0","5","3.20"
"107345","12","12","12","0","7","3.20"
"107452","16","16","13","3","12","3.20"
"107458","8","8","7","1","7","3.20"
"107879","10","10","10","0","9","3.20"
"107909","13","13","12","1","10","3.20"
"107988","14","14","12","2","7","3.20"
"108053","15","15","15","0","9","3.20"
"108105","8","8","8","0","7","3.20"
"108122","10","10","10","0","7","3.20"
"108206","12","12","11","1","6","3.20"
"108254","12","12","7","5","5","3.20"
"108298","16","16","12","4","8","3.20"
"108391","21","20","20","1","14","3.20"
"108457","12","12","11","1","9","3.20"
"108499","12","12","11","1","8","3.20"
"108520","18","18","16","2","9","3.20"
"108614","18","18","14","4","9","3.20"
"108629","14","13","14","0","11","3.20"
"108679","11","11","10","1","9","3.20"
"108702","22","22","17","5","9","3.20"
"108789","9","9","8","1","7","3.20"
"108796","23","23","21","2","14","3.20"
"108917","13","13","10","3","6","3.20"
"109054","9","9","9","0","6","3.20"
"109148","16","16","15","1","10","3.20"
"109368","10","10","9","1","6","3.20"
"109429","17","17","16","1","9","3.20"
"109437","14","14","13","1","8","3.20"
"109527","8","8","8","0","6","3.20"
"109729","10","10","10","0","5","3.20"
"109778","16","16","16","0","10","3.20"
"109802","12","12","12","0","11","3.20"
"109824","7","7","6","1","6","3.20"
"110021","15","15","13","2","6","3.20"
"110086","15","15","15","0","9","3.20"
"110317","17","17","15","2","10","3.20"
"110438","13","13","12","1","7","3.20"
"110572","17","17","17","0","11","3.20"
"110752","16","16","12","4","7","3.20"
"110884","18","18","17","1","13","3.20"
"111094","11","11","9","2","8","3.20"
"111231","16","16","12","4","10","3.20"
"111283","9","9","6","3","5","3.20"
"111306","10","10","10","0","7","3.20"
"111325","14","14","12","2","10","3.20"
"111387","10","10","10","0","9","3.20"
"111590","14","14","13","1","8","3.20"
"111591","16","16","15","1","13","3.20"
"111624","13","13","10","3","6","3.20"
"111795","10","10","10","0","6","3.20"
"111831","8","8","7","1","6","3.20"
"111899","10","10","8","2","6","3.20"
"112010","11","11","10","1","6","3.20"
"112128","16","16","15","1","7","3.20"
"112478","23","23","21","2","14","3.20"
"112564","22","22","21","1","14","3.20"
"112654","16","16","14","2","7","3.20"
"112769","17","17","12","5","7","3.20"
"112942","10","10","10","0","6","3.20"
"112959","7","7","7","0","5","3.20"
"113056","7","7","7","0","5","3.20"
"113071","15","15","11","4","9","3.20"
"113100","8","8","7","1","5","3.20"
"113128","10","10","10","0","5","3.20"
"113148","18","18","16","2","12","3.20"
"113156","12","12","12","0","7","3.20"
"113387","12","12","12","0","11","3.20"
"113408","15","15","14","1","11","3.20"
"113458","16","16","13","3","10","3.20"
"113587","11","11","10","1","5","3.20"
"113607","11","11","10","1","8","3.20"
"113611","11","11","10","1","7","3.20"
"113647","14","14","13","1","10","3.20"
"113686","25","25","23","2","19","3.20"
"113707","16","16","15","1","9","3.20"
"113858","18","18","16","2","13","3.20"
"113921","12","12","12","0","7","3.20"
"114042","15","15","14","1","8","3.20"
"114354","22","22","18","4","14","3.20"
"114374","11","11","10","1","6","3.20"
"114489","13","13","11","2","7","3.20"
"114495","12","12","9","3","7","3.20"
"114555","16","16","14","2","9","3.20"
"114665","15","15","15","0","9","3.20"
"114702","15","15","14","1","9","3.20"
"114709","20","20","19","1","13","3.20"
"114718","16","16","16","0","8","3.20"
"114782","12","12","11","1","5","3.20"
"114901","14","14","12","2","6","3.20"
"115011","11","11","10","1","6","3.20"
"115048","12","12","12","0","8","3.20"
"115083","15","15","14","1","10","3.20"
"115280","16","16","14","2","13","3.20"
"115396","12","12","11","1","6","3.20"
"115441","12","12","11","1","9","3.20"
"115446","14","14","11","3","8","3.20"
"115455","11","11","9","2","6","3.20"
"115459","11","11","11","0","9","3.20"
"115496","14","14","12","2","7","3.20"
"115575","16","16","14","2","10","3.20"
"115631","9","9","9","0","7","3.20"
"115936","16","16","14","2","10","3.20"
"115994","9","9","6","3","5","3.20"
"116113","17","17","17","0","10","3.20"
"116131","8","8","8","0","5","3.20"
"116217","16","16","13","3","7","3.20"
"116253","22","22","20","2","13","3.20"
"116300","9","9","9","0","7","3.20"
"116350","15","15","14","1","6","3.20"
"116388","8","8","6","2","5","3.20"
"116498","16","16","13","3","7","3.20"
"116689","23","23","20","3","13","3.20"
"116728","13","13","11","2","7","3.20"
"116775","19","19","15","4","9","3.20"
"116776","16","16","15","1","12","3.20"
"116847","8","8","7","1","5","3.20"
"116906","15","15","13","2","8","3.20"
"116955","9","9","8","1","7","3.20"
"117118","14","14","12","2","8","3.20"
"117207","12","12","10","2","5","3.20"
"117458","17","17","11","6","7","3.20"
"117530","21","21","19","2","13","3.20"
"100108","17","17","14","3","11","3.19"
"100235","19","19","18","1","10","3.19"
"100289","15","15","15","0","9","3.19"
"100372","11","11","11","0","7","3.19"
"100502","20","20","17","3","11","3.19"
"100605","17","17","17","0","11","3.19"
"101010","25","25","23","2","16","3.19"
"101082","19","19","18","1","14","3.19"
"101099","17","16","15","2","12","3.19"
"101205","19","19","18","1","12","3.19"
"101421","12","12","12","0","9","3.19"
"101632","23","23","20","3","12","3.19"
"102088","16","16","15","1","11","3.19"
"102244","18","18","16","2","13","3.19"
"102257","17","17","16","1","12","3.19"
"102267","18","18","18","0","13","3.19"
"102293","19","19","16","3","14","3.19"
"102480","16","16","15","1","9","3.19"
"102493","22","22","19","3","16","3.19"
"102735","12","12","10","2","10","3.19"
"103164","15","15","14","1","11","3.19"
"103285","17","17","16","1","13","3.19"
"103299","15","15","14","1","9","3.19"
"103423","13","13","11","2","9","3.19"
"103468","22","22","18","4","11","3.19"
"103606","15","15","11","4","10","3.19"
"103614","16","16","14","2","9","3.19"
"103918","18","18","17","1","10","3.19"
"104089","15","15","15","0","12","3.19"
"104290","19","19","17","2","13","3.19"
"104738","19","19","16","3","11","3.19"
"105007","13","13","13","0","10","3.19"
"105036","20","20","17","3","12","3.19"
"105121","15","15","12","3","10","3.19"
"105582","18","18","18","0","14","3.19"
"105719","20","20","16","4","11","3.19"
"105721","19","19","19","0","16","3.19"
"105725","19","19","18","1","13","3.19"
"105869","15","15","15","0","12","3.19"
"106155","21","21","20","1","12","3.19"
"106518","19","19","15","4","12","3.19"
"106574","14","14","14","0","11","3.19"
"106613","14","14","13","1","9","3.19"
"106785","14","14","13","1","11","3.19"
"106847","23","23","19","4","11","3.19"
"106928","14","14","13","1","11","3.19"
"107400","17","17","16","1","11","3.19"
"107613","24","24","23","1","16","3.19"
"107959","22","22","20","2","12","3.19"
"108305","16","16","15","1","10","3.19"
"108421","15","15","13","2","11","3.19"
"108699","15","15","12","3","9","3.19"
"108766","17","17","16","1","12","3.19"
"108861","22","22","19","3","13","3.19"
"109195","15","15","14","1","10","3.19"
"109535","17","17","16","1","11","3.19"
"109620","13","13","13","0","10","3.19"
"109697","21","21","18","3","9","3.19"
"110125","13","13","13","0","9","3.19"
"110180","16","16","15","1","10","3.19"
"110231","14","14","13","1","12","3.19"
"111033","15","15","14","1","9","3.19"
"111410","13","13","12","1","12","3.19"
"111514","19","19","15","4","12","3.19"
"111951","14","14","13","1","13","3.19"
"112011","20","20","19","1","14","3.19"
"112150","18","18","16","2","13","3.19"
"112342","19","19","17","2","14","3.19"
"112507","19","19","19","0","16","3.19"
"112771","20","20","18","2","13","3.19"
"112835","17","17","17","0","11","3.19"
"112906","24","24","22","2","12","3.19"
"113450","15","15","15","0","13","3.19"
"113499","18","18","18","0","15","3.19"
"113717","13","13","13","0","11","3.19"
"113785","18","18","18","0","11","3.19"
"113862","14","14","12","2","9","3.19"
"114355","21","21","18","3","14","3.19"
"114731","18","18","14","4","8","3.19"
"114861","18","18","18","0","12","3.19"
"115075","19","19","18","1","9","3.19"
"115099","19","19","18","1","13","3.19"
"115102","22","22","20","2","16","3.19"
"115579","24","24","21","3","11","3.19"
"115766","18","18","18","0","14","3.19"
"115875","14","14","13","1","11","3.19"
"116199","13","13","11","2","9","3.19"
"116204","12","12","12","0","10","3.19"
"116336","15","15","13","2","10","3.19"
"116747","15","15","15","0","11","3.19"
"116842","19","19","18","1","10","3.19"
"117028","13","13","12","1","11","3.19"
"117042","17","17","16","1","11","3.19"
"117126","12","12","12","0","9","3.19"
"117142","10","10","10","0","7","3.19"
"117276","14","14","13","1","11","3.19"
"102353","14","14","13","1","11","3.18"
"103576","20","20","17","3","15","3.18"
"104277","15","15","13","2","12","3.18"
"105174","22","22","21","1","14","3.18"
"107149","17","16","16","1","11","3.18"
"107798","18","18","16","2","14","3.18"
"109842","22","22","18","4","10","3.18"
"109958","15","15","13","2","9","3.18"
"110988","16","16","16","0","12","3.18"
"111666","22","22","20","2","12","3.18"
"111919","20","20","19","1","13","3.18"
"113063","14","14","14","0","12","3.18"
"113110","19","19","16","3","12","3.18"
"114393","22","22","21","1","16","3.18"
"114571","16","16","16","0","13","3.18"
"115168","19","19","15","4","12","3.18"
"115370","20","20","18","2","14","3.18"
"115750","13","13","13","0","13","3.18"
"116067","25","25","21","4","16","3.18"
"100051","15","15","13","2","9","3.17"
"100071","11","11","10","1","9","3.17"
"100136","13","13","12","1","7","3.17"
"100278","10","10","10","0","8","3.17"
"100311","22","22","21","1","15","3.17"
"100331","20","20","20","0","14","3.17"
"100391","16","16","14","2","9","3.17"
"100470","11","11","9","2","7","3.17"
"100615","13","13","11","2","8","3.17"
"100628","7","7","7","0","4","3.17"
"100676","12","12","12","0","10","3.17"
"100732","10","10","9","1","7","3.17"
"100771","16","16","15","1","8","3.17"
"100786","10","10","8","2","6","3.17"
"100804","13","13","13","0","9","3.17"
"100811","17","17","16","1","8","3.17"
"100901","17","17","16","1","13","3.17"
"100903","14","14","13","1","9","3.17"
"100951","13","13","10","3","6","3.17"
"100983","6","6","6","0","4","3.17"
"101036","13","13","13","0","6","3.17"
"101201","7","7","7","0","7","3.17"
"101238","11","11","10","1","8","3.17"
"101240","12","12","12","0","11","3.17"
"101247","15","15","13","2","11","3.17"
"101253","14","13","14","0","10","3.17"
"101429","14","14","13","1","9","3.17"
"101555","12","12","12","0","9","3.17"
"101677","14","14","14","0","10","3.17"
"101731","14","14","13","1","8","3.17"
"101766","10","10","9","1","6","3.17"
"101871","17","17","14","3","6","3.17"
"101981","15","15","15","0","7","3.17"
"101987","13","13","12","1","10","3.17"
"102096","11","11","10","1","8","3.17"
"102145","14","14","14","0","10","3.17"
"102160","15","15","15","0","7","3.17"
"102350","11","11","9","2","7","3.17"
"102359","13","13","13","0","7","3.17"
"102465","11","11","10","1","6","3.17"
"102538","12","12","10","2","5","3.17"
"102647","17","17","16","1","9","3.17"
"102688","10","10","9","1","8","3.17"
"102776","15","15","14","1","8","3.17"
"102821","13","13","11","2","8","3.17"
"102832","8","8","8","0","4","3.17"
"102867","15","15","14","1","11","3.17"
"102887","12","12","11","1","9","3.17"
"102945","14","14","14","0","10","3.17"
"103017","10","10","7","3","4","3.17"
"103029","15","14","12","3","4","3.17"
"103125","17","17","13","4","6","3.17"
"103213","19","19","18","1","9","3.17"
"103282","14","14","14","0","10","3.17"
"103286","14","14","11","3","7","3.17"
"103326","16","16","10","6","10","3.17"
"103344","23","23","20","3","14","3.17"
"103371","8","8","8","0","6","3.17"
"103409","11","11","10","1","7","3.17"
"103471","14","14","12","2","6","3.17"
"103521","12","12","11","1","7","3.17"
"103533","12","12","11","1","7","3.17"
"103588","16","16","15","1","10","3.17"
"103594","11","11","9","2","7","3.17"
"103608","16","16","12","4","8","3.17"
"103634","11","11","10","1","7","3.17"
"103639","15","15","12","3","9","3.17"
"103718","17","17","17","0","9","3.17"
"103878","13","13","11","2","6","3.17"
"103944","20","20","20","0","13","3.17"
"104204","10","10","8","2","6","3.17"
"104354","13","13","11","2","6","3.17"
"104362","16","16","13","3","11","3.17"
"104369","10","10","9","1","7","3.17"
"104394","9","9","7","2","6","3.17"
"104432","13","13","11","2","6","3.17"
"104503","17","17","17","0","11","3.17"
"104533","7","7","7","0","5","3.17"
"104590","6","6","5","1","4","3.17"
"104748","13","13","12","1","7","3.17"
"104788","13","13","12","1","8","3.17"
"104798","18","18","14","4","10","3.17"
"104848","11","11","10","1","7","3.17"
"104867","11","11","11","0","7","3.17"
"104962","15","15","13","2","11","3.17"
"104987","12","12","12","0","5","3.17"
"105249","15","15","11","4","8","3.17"
"105257","11","11","10","1","6","3.17"
"105296","14","14","13","1","10","3.17"
"105302","14","14","13","1","7","3.17"
"105355","11","11","11","0","7","3.17"
"105372","17","17","15","2","10","3.17"
"105374","11","11","10","1","7","3.17"
"105384","16","16","11","5","8","3.17"
"105406","9","8","8","1","4","3.17"
"105413","8","8","6","2","4","3.17"
"105492","13","13","10","3","7","3.17"
"105536","12","12","11","1","4","3.17"
"105656","12","12","9","3","8","3.17"
"105659","13","13","13","0","7","3.17"
"105750","11","11","11","0","9","3.17"
"105758","15","15","14","1","8","3.17"
"105781","19","19","18","1","14","3.17"
"105816","13","13","11","2","7","3.17"
"105867","19","19","17","2","14","3.17"
"105877","11","11","8","3","7","3.17"
"105947","13","13","11","2","5","3.17"
"105969","15","15","14","1","9","3.17"
"105983","11","11","11","0","11","3.17"
"105991","12","12","11","1","7","3.17"
"106129","11","11","9","2","7","3.17"
"106185","10","10","10","0","7","3.17"
"106341","7","7","7","0","7","3.17"
"106415","20","20","19","1","14","3.17"
"106432","13","13","13","0","8","3.17"
"106444","8","8","7","1","6","3.17"
"106605","17","17","15","2","7","3.17"
"106695","14","14","12","2","8","3.17"
"106696","14","14","13","1","10","3.17"
"106751","18","17","17","1","11","3.17"
"106829","16","16","15","1","10","3.17"
"106832","8","8","8","0","7","3.17"
"106860","14","14","11","3","8","3.17"
"106978","17","17","15","2","11","3.17"
"107031","7","7","5","2","5","3.17"
"107260","14","14","13","1","8","3.17"
"107281","15","15","13","2","9","3.17"
"107285","11","11","9","2","6","3.17"
"107286","15","15","14","1","11","3.17"
"107344","17","17","13","4","10","3.17"
"107374","10","10","7","3","6","3.17"
"107432","10","10","10","0","8","3.17"
"107436","16","16","15","1","12","3.17"
"107518","12","12","12","0","7","3.17"
"107538","18","18","17","1","11","3.17"
"107552","18","18","16","2","13","3.17"
"107574","17","17","16","1","13","3.17"
"107589","12","12","11","1","8","3.17"
"107611","12","12","12","0","9","3.17"
"107632","15","15","11","4","8","3.17"
"107681","10","10","9","1","7","3.17"
"107727","15","15","14","1","9","3.17"
"107776","11","11","10","1","5","3.17"
"107811","24","24","23","1","15","3.17"
"107830","9","9","7","2","4","3.17"
"107905","10","10","9","1","7","3.17"
"107912","13","13","12","1","9","3.17"
"107963","12","12","8","4","6","3.17"
"108005","13","13","12","1","6","3.17"
"108011","17","17","16","1","10","3.17"
"108027","11","11","9","2","6","3.17"
"108064","17","17","16","1","10","3.17"
"108099","14","14","14","0","8","3.17"
"108195","18","18","16","2","5","3.17"
"108316","14","14","12","2","7","3.17"
"108458","13","13","11","2","7","3.17"
"108562","14","14","12","2","8","3.17"
"108568","12","12","12","0","11","3.17"
"108602","13","13","11","2","7","3.17"
"108628","14","14","12","2","8","3.17"
"108685","17","17","13","4","9","3.17"
"108740","15","15","13","2","5","3.17"
"108911","21","21","17","4","13","3.17"
"109112","21","21","20","1","13","3.17"
"109158","19","19","18","1","14","3.17"
"109235","13","13","12","1","10","3.17"
"109278","13","13","12","1","10","3.17"
"109285","12","12","8","4","5","3.17"
"109379","14","13","13","1","9","3.17"
"109500","15","15","14","1","11","3.17"
"109513","14","14","12","2","8","3.17"
"109546","12","12","11","1","10","3.17"
"109578","12","12","10","2","7","3.17"
"109644","18","18","16","2","10","3.17"
"109748","10","10","8","2","5","3.17"
"109821","13","13","11","2","8","3.17"
"109885","11","11","10","1","6","3.17"
"109925","12","12","10","2","8","3.17"
"110049","11","11","10","1","8","3.17"
"110141","5","5","5","0","4","3.17"
"110197","18","18","16","2","12","3.17"
"110204","12","12","9","3","6","3.17"
"110222","18","18","18","0","10","3.17"
"110259","14","14","12","2","8","3.17"
"110307","10","10","10","0","8","3.17"
"110367","14","14","14","0","11","3.17"
"110444","14","14","13","1","8","3.17"
"110446","11","11","9","2","7","3.17"
"110471","14","14","14","0","11","3.17"
"110702","14","14","12","2","7","3.17"
"110780","12","12","12","0","10","3.17"
"110782","17","17","16","1","10","3.17"
"110887","13","13","13","0","11","3.17"
"110915","7","7","7","0","7","3.17"
"111036","26","26","18","8","12","3.17"
"111080","16","16","12","4","8","3.17"
"111125","10","10","10","0","4","3.17"
"111149","14","14","12","2","6","3.17"
"111174","14","14","12","2","11","3.17"
"111216","16","16","15","1","9","3.17"
"111432","15","15","13","2","10","3.17"
"111495","9","9","9","0","4","3.17"
"111552","10","10","10","0","7","3.17"
"111894","8","8","8","0","6","3.17"
"111942","7","7","7","0","4","3.17"
"111963","14","14","13","1","7","3.17"
"111992","14","14","13","1","9","3.17"
"112032","8","8","7","1","4","3.17"
"112079","14","14","14","0","9","3.17"
"112336","13","13","13","0","11","3.17"
"112361","18","18","15","3","11","3.17"
"112469","10","10","10","0","6","3.17"
"112520","14","14","14","0","7","3.17"
"112610","14","14","11","3","8","3.17"
"112755","14","14","13","1","12","3.17"
"112758","20","20","17","3","7","3.17"
"112785","9","9","8","1","6","3.17"
"112905","12","12","10","2","8","3.17"
"112915","9","9","9","0","7","3.17"
"113006","19","19","16","3","13","3.17"
"113034","19","19","18","1","12","3.17"
"113050","14","14","11","3","8","3.17"
"113097","21","21","21","0","15","3.17"
"113222","13","13","13","0","11","3.17"
"113230","11","11","11","0","6","3.17"
"113275","16","16","12","4","8","3.17"
"113287","10","10","10","0","8","3.17"
"113294","20","20","18","2","11","3.17"
"113398","14","14","11","3","9","3.17"
"113551","10","10","10","0","7","3.17"
"113571","23","23","21","2","12","3.17"
"113591","17","17","14","3","7","3.17"
"113699","20","20","18","2","12","3.17"
"113790","7","7","7","0","4","3.17"
"113800","16","16","16","0","12","3.17"
"114030","12","12","10","2","7","3.17"
"114088","9","9","8","1","4","3.17"
"114092","9","9","7","2","4","3.17"
"114125","13","13","12","1","8","3.17"
"114148","16","16","15","1","12","3.17"
"114193","10","10","10","0","6","3.17"
"114424","11","11","11","0","7","3.17"
"114440","8","8","8","0","6","3.17"
"114469","13","13","11","2","5","3.17"
"114540","13","13","13","0","5","3.17"
"114613","17","17","13","4","10","3.17"
"114624","13","13","13","0","11","3.17"
"114647","21","21","17","4","10","3.17"
"114676","13","13","12","1","7","3.17"
"114770","11","11","10","1","9","3.17"
"114828","8","8","8","0","6","3.17"
"114860","15","15","14","1","9","3.17"
"114964","20","20","17","3","11","3.17"
"115275","15","15","13","2","9","3.17"
"115362","9","9","7","2","4","3.17"
"115401","10","10","8","2","5","3.17"
"115437","13","13","11","2","10","3.17"
"115490","9","9","7","2","4","3.17"
"115612","9","9","9","0","7","3.17"
"115641","15","15","14","1","8","3.17"
"115671","15","15","15","0","9","3.17"
"115714","10","10","9","1","5","3.17"
"115821","15","15","15","0","9","3.17"
"115826","24","24","21","3","17","3.17"
"115947","12","12","9","3","6","3.17"
"116301","13","13","11","2","6","3.17"
"116376","15","14","11","4","7","3.17"
"116504","14","14","12","2","9","3.17"
"116507","17","17","15","2","12","3.17"
"116552","15","15","11","4","9","3.17"
"116585","12","12","11","1","10","3.17"
"116821","19","19","16","3","10","3.17"
"116865","17","17","17","0","13","3.17"
"116963","7","7","7","0","6","3.17"
"116969","16","16","15","1","10","3.17"
"116972","13","13","12","1","4","3.17"
"117052","13","13","12","1","6","3.17"
"117087","12","12","12","0","6","3.17"
"117172","16","16","15","1","9","3.17"
"117240","19","19","17","2","12","3.17"
"117393","13","13","13","0","12","3.17"
"117397","13","13","11","2","8","3.17"
"117403","18","18","17","1","11","3.17"
"117479","13","13","10","3","8","3.17"
"117483","13","13","10","3","7","3.17"
"117490","22","22","20","2","15","3.17"
"117594","16","16","14","2","7","3.17"
"117607","13","13","11","2","10","3.17"
"101062","25","25","23","2","19","3.16"
"107053","19","19","17","2","15","3.16"
"108326","24","24","23","1","15","3.16"
"111557","18","18","17","1","11","3.16"
"112276","23","23","21","2","16","3.16"
"112995","17","17","14","3","13","3.16"
"113928","20","20","19","1","16","3.16"
"114675","12","12","10","2","9","3.16"
"114710","16","16","14","2","13","3.16"
"116913","17","17","16","1","13","3.16"
"100984","17","17","16","1","12","3.15"
"101192","18","18","15","3","10","3.15"
"101235","22","22","21","1","15","3.15"
"101447","15","15","15","0","12","3.15"
"101548","18","18","17","1","12","3.15"
"102777","18","18","16","2","15","3.15"
"102804","17","17","17","0","14","3.15"
"103012","18","18","16","2","10","3.15"
"103424","19","19","17","2","16","3.15"
"103660","19","19","16","3","14","3.15"
"104012","19","19","18","1","15","3.15"
"104729","17","17","17","0","13","3.15"
"105088","22","22","21","1","16","3.15"
"106513","23","23","19","4","15","3.15"
"106773","13","13","11","2","9","3.15"
"107065","18","18","18","0","14","3.15"
"107357","18","18","14","4","13","3.15"
"107371","19","19","17","2","12","3.15"
"107839","14","14","14","0","12","3.15"
"108297","17","17","16","1","13","3.15"
"108338","16","16","14","2","13","3.15"
"108513","16","16","14","2","12","3.15"
"108761","16","16","16","0","12","3.15"
"108932","17","17","16","1","12","3.15"
"110004","24","24","22","2","17","3.15"
"110926","9","9","9","0","8","3.15"
"111183","19","19","17","2","13","3.15"
"111416","14","14","12","2","10","3.15"
"111807","14","14","12","2","9","3.15"
"113120","20","20","19","1","13","3.15"
"113299","15","15","14","1","11","3.15"
"113421","18","18","17","1","11","3.15"
"113696","14","14","12","2","9","3.15"
"114842","19","19","19","0","10","3.15"
"115395","16","16","14","2","10","3.15"
"116100","16","16","15","1","11","3.15"
"117131","16","16","16","0","12","3.15"
"117137","20","20","18","2","15","3.15"
"117159","15","15","14","1","11","3.15"
"117491","14","14","13","1","11","3.15"
"117555","18","18","16","2","14","3.15"
"100001","20","20","19","1","14","3.14"
"100180","14","14","13","1","11","3.14"
"100335","19","19","18","1","12","3.14"
"100403","17","17","13","4","7","3.14"
"100467","13","13","10","3","7","3.14"
"100520","19","19","16","3","11","3.14"
"100596","19","19","17","2","11","3.14"
"100661","21","21","20","1","15","3.14"
"100783","18","18","15","3","11","3.14"
"100968","14","14","11","3","7","3.14"
"101154","15","15","15","0","11","3.14"
"101183","18","18","15","3","10","3.14"
"101273","11","11","10","1","9","3.14"
"101367","15","15","15","0","11","3.14"
"101404","19","19","18","1","12","3.14"
"101427","18","18","17","1","15","3.14"
"101481","13","13","12","1","8","3.14"
"101551","19","19","17","2","13","3.14"
"101664","20","20","19","1","13","3.14"
"101919","21","21","18","3","15","3.14"
"102004","9","9","9","0","9","3.14"
"102248","22","22","19","3","15","3.14"
"102304","11","11","11","0","7","3.14"
"102657","17","17","17","0","10","3.14"
"102717","15","15","14","1","12","3.14"
"102798","16","16","15","1","11","3.14"
"103157","15","15","12","3","7","3.14"
"103163","16","16","16","0","13","3.14"
"103184","14","14","14","0","11","3.14"
"103654","15","15","14","1","8","3.14"
"103743","17","17","17","0","13","3.14"
"103960","21","21","17","4","11","3.14"
"104108","16","16","12","4","9","3.14"
"104156","16","16","15","1","8","3.14"
"104311","14","14","14","0","9","3.14"
"104350","12","12","11","1","7","3.14"
"104356","20","20","20","0","13","3.14"
"104396","16","16","15","1","11","3.14"
"104577","15","15","15","0","11","3.14"
"104642","17","17","13","4","9","3.14"
"104934","9","9","8","1","8","3.14"
"104947","13","13","13","0","10","3.14"
"105018","14","14","13","1","10","3.14"
"105176","15","14","13","2","10","3.14"
"105584","18","18","17","1","10","3.14"
"105627","16","16","16","0","9","3.14"
"105956","13","13","11","2","8","3.14"
"105973","12","12","12","0","8","3.14"
"106002","13","13","11","2","7","3.14"
"106196","16","16","15","1","10","3.14"
"106363","14","14","13","1","11","3.14"
"106512","16","16","16","0","8","3.14"
"106577","16","16","15","1","13","3.14"
"106658","20","19","16","4","10","3.14"
"106686","13","13","13","0","12","3.14"
"107607","13","13","12","1","8","3.14"
"107709","14","14","14","0","10","3.14"
"108096","16","16","14","2","10","3.14"
"108148","11","11","10","1","9","3.14"
"108151","14","14","13","1","10","3.14"
"108319","12","12","12","0","8","3.14"
"108344","16","16","14","2","14","3.14"
"108625","12","12","11","1","10","3.14"
"108690","16","16","15","1","9","3.14"
"108771","15","15","15","0","10","3.14"
"108783","14","14","11","3","10","3.14"
"108976","13","13","11","2","7","3.14"
"109016","13","13","11","2","7","3.14"
"109203","14","14","12","2","10","3.14"
"109213","15","15","14","1","7","3.14"
"109343","17","17","14","3","8","3.14"
"109491","14","14","14","0","10","3.14"
"109571","12","12","10","2","8","3.14"
"109626","24","24","19","5","12","3.14"
"109794","16","16","15","1","10","3.14"
"109896","15","15","12","3","10","3.14"
"109904","15","15","13","2","10","3.14"
"109913","15","15","15","0","9","3.14"
"110101","13","13","12","1","8","3.14"
"110102","16","16","14","2","10","3.14"
"110144","12","12","11","1","10","3.14"
"110159","14","14","14","0","10","3.14"
"110357","12","12","12","0","9","3.14"
"110453","16","16","16","0","10","3.14"
"110525","17","17","16","1","11","3.14"
"110991","10","10","9","1","7","3.14"
"111063","14","14","14","0","10","3.14"
"111072","13","13","11","2","10","3.14"
"111090","10","10","10","0","8","3.14"
"111381","16","16","15","1","8","3.14"
"111418","17","17","14","3","7","3.14"
"111429","16","16","15","1","13","3.14"
"111497","14","14","12","2","9","3.14"
"111506","11","11","10","1","9","3.14"
"111695","15","15","15","0","10","3.14"
"111789","14","14","12","2","9","3.14"
"112209","17","17","15","2","9","3.14"
"112447","15","15","15","0","10","3.14"
"112492","15","15","14","1","10","3.14"
"112553","13","13","11","2","9","3.14"
"112583","17","17","15","2","12","3.14"
"112926","14","14","14","0","10","3.14"
"113129","17","17","15","2","11","3.14"
"113324","12","12","12","0","10","3.14"
"113487","19","19","17","2","10","3.14"
"113613","18","18","17","1","13","3.14"
"113854","14","14","12","2","9","3.14"
"113882","15","15","15","0","10","3.14"
"114074","10","10","9","1","8","3.14"
"114168","9","9","8","1","7","3.14"
"114279","25","25","22","3","12","3.14"
"114360","10","10","10","0","7","3.14"
"114570","12","12","11","1","9","3.14"
"114682","13","13","12","1","9","3.14"
"114688","17","17","14","3","9","3.14"
"114727","13","13","13","0","9","3.14"
"114742","18","18","15","3","11","3.14"
"114838","13","13","10","3","9","3.14"
"114846","18","18","15","3","10","3.14"
"114847","14","14","12","2","10","3.14"
"114848","20","20","17","3","13","3.14"
"114939","15","15","15","0","9","3.14"
"114945","10","10","10","0","8","3.14"
"114955","20","20","18","2","12","3.14"
"115214","17","17","17","0","13","3.14"
"115386","22","22","21","1","13","3.14"
"115389","19","19","19","0","14","3.14"
"115493","21","21","20","1","13","3.14"
"115541","14","14","13","1","8","3.14"
"115608","15","15","13","2","9","3.14"
"116049","14","14","12","2","7","3.14"
"116249","19","19","18","1","11","3.14"
"116321","17","17","14","3","12","3.14"
"116627","15","15","13","2","9","3.14"
"116712","16","16","13","3","7","3.14"
"116805","17","17","15","2","9","3.14"
"117083","13","13","12","1","9","3.14"
"117092","15","15","13","2","9","3.14"
"117163","18","18","16","2","13","3.14"
"117478","15","15","12","3","10","3.14"
"117481","13","13","11","2","9","3.14"
"117537","18","18","15","3","11","3.14"
"100049","17","17","16","1","12","3.13"
"100055","12","12","11","1","7","3.13"
"100058","15","15","14","1","10","3.13"
"100063","11","11","10","1","7","3.13"
"100192","9","9","8","1","7","3.13"
"100267","8","8","7","1","6","3.13"
"100529","7","7","6","1","5","3.13"
"100635","16","16","14","2","10","3.13"
"100689","13","13","12","1","11","3.13"
"100867","14","14","11","3","7","3.13"
"100904","19","19","17","2","12","3.13"
"100905","15","15","12","3","7","3.13"
"101228","15","15","14","1","10","3.13"
"101249","14","14","12","2","6","3.13"
"101340","11","11","11","0","5","3.13"
"101371","9","9","8","1","7","3.13"
"101390","13","13","12","1","5","3.13"
"101560","18","18","16","2","12","3.13"
"101797","14","14","13","1","6","3.13"
"101869","7","7","7","0","5","3.13"
"101898","10","10","8","2","5","3.13"
"102029","14","14","13","1","10","3.13"
"102040","14","14","13","1","9","3.13"
"102071","10","10","9","1","7","3.13"
"102198","20","20","17","3","12","3.13"
"102295","8","8","6","2","5","3.13"
"102386","22","22","21","1","17","3.13"
"102453","15","15","14","1","10","3.13"
"102603","17","17","17","0","13","3.13"
"102611","19","19","16","3","12","3.13"
"102780","12","12","12","0","10","3.13"
"102815","16","16","15","1","10","3.13"
"102826","12","12","11","1","9","3.13"
"102852","19","19","19","0","14","3.13"
"102874","11","11","9","2","5","3.13"
"102908","10","10","9","1","7","3.13"
"102952","13","13","13","0","6","3.13"
"103058","13","13","13","0","9","3.13"
"103072","13","13","11","2","7","3.13"
"103089","19","19","15","4","10","3.13"
"103291","13","13","12","1","8","3.13"
"103389","9","9","8","1","7","3.13"
"103436","17","17","16","1","13","3.13"
"103601","17","16","17","0","14","3.13"
"103697","17","17","16","1","11","3.13"
"103796","16","16","16","0","9","3.13"
"103877","14","14","14","0","10","3.13"
"103892","16","16","16","0","7","3.13"
"104063","17","17","16","1","12","3.13"
"104102","9","9","8","1","7","3.13"
"104305","16","16","14","2","10","3.13"
"104347","16","16","14","2","12","3.13"
"104508","15","15","10","5","9","3.13"
"104725","17","17","17","0","10","3.13"
"104873","13","13","10","3","6","3.13"
"105105","17","17","13","4","10","3.13"
"105220","19","19","13","6","10","3.13"
"105283","18","18","15","3","8","3.13"
"105300","17","17","15","2","12","3.13"
"105567","15","15","12","3","8","3.13"
"105658","14","14","11","3","8","3.13"
"105738","16","16","15","1","9","3.13"
"105828","11","11","10","1","9","3.13"
"105840","15","15","11","4","8","3.13"
"106053","8","8","7","1","5","3.13"
"106101","15","15","14","1","12","3.13"
"106258","17","17","17","0","13","3.13"
"106385","12","12","10","2","6","3.13"
"106417","11","11","11","0","5","3.13"
"106479","12","12","10","2","7","3.13"
"106614","11","11","11","0","6","3.13"
"106711","16","16","14","2","10","3.13"
"106776","8","8","7","1","6","3.13"
"106778","10","10","9","1","5","3.13"
"106848","7","7","7","0","5","3.13"
"107058","10","10","10","0","7","3.13"
"107080","13","13","11","2","6","3.13"
"107277","12","12","11","1","7","3.13"
"107318","23","23","21","2","16","3.13"
"107381","23","23","22","1","13","3.13"
"107464","15","15","14","1","11","3.13"
"107697","11","11","11","0","5","3.13"
"107767","13","13","11","2","10","3.13"
"107805","11","11","10","1","7","3.13"
"107872","16","16","15","1","11","3.13"
"107928","18","18","16","2","13","3.13"
"107957","9","9","9","0","7","3.13"
"107967","9","9","9","0","6","3.13"
"108026","8","8","7","1","6","3.13"
"108029","13","13","13","0","10","3.13"
"108084","23","23","21","2","13","3.13"
"108179","8","8","8","0","6","3.13"
"108199","18","18","15","3","11","3.13"
"108373","15","15","15","0","11","3.13"
"108414","14","14","13","1","9","3.13"
"108482","15","15","12","3","9","3.13"
"108514","10","10","9","1","6","3.13"
"108585","18","18","17","1","10","3.13"
"108669","11","11","10","1","5","3.13"
"108692","16","16","15","1","10","3.13"
"108698","13","13","13","0","7","3.13"
"108729","11","11","9","2","6","3.13"
"108747","12","12","10","2","8","3.13"
"108881","14","14","13","1","9","3.13"
"108915","12","12","11","1","7","3.13"
"108929","13","13","13","0","7","3.13"
"109023","14","14","12","2","9","3.13"
"109031","20","20","17","3","13","3.13"
"109048","13","13","12","1","6","3.13"
"109178","16","16","14","2","7","3.13"
"109196","12","12","10","2","7","3.13"
"109221","15","15","14","1","10","3.13"
"109317","17","17","16","1","10","3.13"
"109335","12","12","10","2","8","3.13"
"109561","12","12","12","0","8","3.13"
"109680","11","11","10","1","8","3.13"
"109782","17","17","15","2","11","3.13"
"109815","18","18","16","2","11","3.13"
"109848","15","15","13","2","8","3.13"
"109930","6","6","6","0","6","3.13"
"109955","8","8","8","0","5","3.13"
"110013","14","14","13","1","9","3.13"
"110150","12","12","12","0","5","3.13"
"110328","18","18","16","2","10","3.13"
"110425","17","17","16","1","14","3.13"
"110472","12","12","9","3","6","3.13"
"110707","11","11","9","2","5","3.13"
"110729","16","16","14","2","8","3.13"
"110911","11","11","8","3","5","3.13"
"111038","12","12","11","1","5","3.13"
"111055","9","9","9","0","7","3.13"
"111130","13","13","11","2","5","3.13"
"111226","17","17","17","0","12","3.13"
"111244","18","18","17","1","11","3.13"
"111437","24","24","22","2","15","3.13"
"111444","20","20","17","3","14","3.13"
"111477","13","13","11","2","7","3.13"
"111496","7","7","7","0","5","3.13"
"111525","25","25","22","3","14","3.13"
"111774","9","9","9","0","6","3.13"
"111908","16","16","15","1","9","3.13"
"111922","8","8","6","2","5","3.13"
"111928","16","16","16","0","9","3.13"
"111934","10","10","10","0","7","3.13"
"111971","13","13","13","0","9","3.13"
"112064","11","11","6","5","5","3.13"
"112105","12","12","11","1","8","3.13"
"112288","19","19","19","0","16","3.13"
"112366","12","12","12","0","9","3.13"
"112373","15","15","15","0","12","3.13"
"112495","11","11","10","1","5","3.13"
"112544","10","10","9","1","5","3.13"
"112565","17","17","13","4","10","3.13"
"112661","12","12","11","1","7","3.13"
"112820","13","13","12","1","7","3.13"
"112839","14","14","13","1","13","3.13"
"112875","11","11","11","0","10","3.13"
"112986","11","11","8","3","5","3.13"
"113223","18","18","16","2","11","3.13"
"113248","27","27","26","1","13","3.13"
"113269","10","10","7","3","5","3.13"
"113273","16","16","15","1","12","3.13"
"113282","12","12","10","2","9","3.13"
"113419","12","12","11","1","8","3.13"
"113745","16","16","13","3","8","3.13"
"113877","11","11","11","0","5","3.13"
"113931","17","17","16","1","8","3.13"
"113959","25","25","20","5","16","3.13"
"114096","15","15","13","2","10","3.13"
"114106","21","21","19","2","13","3.13"
"114165","13","13","12","1","10","3.13"
"114166","10","10","7","3","6","3.13"
"114167","13","13","10","3","6","3.13"
"114183","10","10","9","1","7","3.13"
"114214","23","23","19","4","14","3.13"
"114308","19","19","16","3","12","3.13"
"115109","14","14","13","1","9","3.13"
"115393","19","19","17","2","9","3.13"
"115595","16","16","14","2","10","3.13"
"115804","16","16","13","3","8","3.13"
"115962","12","12","12","0","5","3.13"
"116077","16","16","15","1","12","3.13"
"116208","10","10","9","1","7","3.13"
"116311","9","9","7","2","6","3.13"
"116332","15","14","15","0","9","3.13"
"116373","7","7","7","0","5","3.13"
"116386","7","7","7","0","5","3.13"
"116431","20","20","20","0","15","3.13"
"116611","10","10","9","1","5","3.13"
"116700","14","14","14","0","10","3.13"
"116814","15","15","13","2","10","3.13"
"116831","22","22","16","6","11","3.13"
"116973","17","17","15","2","11","3.13"
"116987","14","14","12","2","8","3.13"
"117269","14","14","12","2","5","3.13"
"117380","14","14","13","1","10","3.13"
"100183","17","17","12","5","11","3.12"
"101823","18","18","18","0","12","3.12"
"102722","17","17","16","1","12","3.12"
"103337","18","18","17","1","11","3.12"
"103358","18","18","18","0","12","3.12"
"103716","21","21","19","2","15","3.12"
"104219","15","15","12","3","10","3.12"
"104339","18","18","18","0","14","3.12"
"104523","17","17","16","1","12","3.12"
"104656","17","17","14","3","11","3.12"
"105395","17","17","14","3","10","3.12"
"106375","17","17","14","3","10","3.12"
"106579","13","13","13","0","9","3.12"
"107356","18","18","18","0","13","3.12"
"107504","21","21","19","2","17","3.12"
"107873","22","22","21","1","19","3.12"
"108264","14","14","14","0","11","3.12"
"108282","20","20","18","2","15","3.12"
"108985","17","17","13","4","10","3.12"
"109610","15","15","14","1","11","3.12"
"110616","17","17","13","4","11","3.12"
"111154","19","19","18","1","10","3.12"
"111351","19","19","19","0","17","3.12"
"111946","15","15","15","0","13","3.12"
"112422","17","17","17","0","14","3.12"
"112463","17","17","17","0","10","3.12"
"112801","15","15","14","1","13","3.12"
"112987","16","16","16","0","10","3.12"
"113062","14","14","13","1","11","3.12"
"113535","12","12","12","0","10","3.12"
"113735","14","14","13","1","10","3.12"
"114486","15","15","14","1","12","3.12"
"114894","18","18","13","5","10","3.12"
"114991","18","18","18","0","10","3.12"
"114994","15","15","14","1","11","3.12"
"115428","16","16","14","2","13","3.12"
"117214","18","18","16","2","12","3.12"
"117501","12","12","12","0","10","3.12"
"117538","15","15","15","0","11","3.12"
"100227","15","15","14","1","8","3.11"
"100326","19","19","17","2","10","3.11"
"100472","16","16","15","1","13","3.11"
"100611","13","13","13","0","10","3.11"
"100681","14","14","12","2","8","3.11"
"100825","11","11","9","2","8","3.11"
"100981","17","16","15","2","10","3.11"
"100989","13","13","13","0","9","3.11"
"101565","12","12","11","1","10","3.11"
"101724","18","18","16","2","10","3.11"
"101848","15","15","14","1","9","3.11"
"102095","13","13","12","1","8","3.11"
"102150","13","13","12","1","9","3.11"
"102702","11","11","11","0","6","3.11"
"102746","18","18","14","4","9","3.11"
"102838","17","17","15","2","8","3.11"
"103066","16","16","13","3","8","3.11"
"103144","12","12","10","2","9","3.11"
"103208","14","14","12","2","8","3.11"
"103300","23","23","20","3","16","3.11"
"103425","13","13","13","0","9","3.11"
"103550","11","11","11","0","9","3.11"
"103553","15","15","11","4","9","3.11"
"103989","11","11","11","0","9","3.11"
"103998","19","19","19","0","12","3.11"
"104048","18","18","18","0","14","3.11"
"104157","17","17","16","1","8","3.11"
"104258","13","13","13","0","9","3.11"
"104720","13","13","12","1","9","3.11"
"105344","18","18","16","2","12","3.11"
"105636","25","25","22","3","13","3.11"
"105999","15","15","13","2","8","3.11"
"106018","19","19","17","2","14","3.11"
"106370","13","13","11","2","5","3.11"
"106446","24","24","20","4","14","3.11"
"106601","10","10","10","0","8","3.11"
"106625","14","14","13","1","9","3.11"
"107384","10","10","10","0","5","3.11"
"107539","14","14","14","0","10","3.11"
"107821","24","24","20","4","14","3.11"
"107941","12","12","11","1","8","3.11"
"108087","15","15","14","1","6","3.11"
"108448","11","11","10","1","8","3.11"
"109540","20","20","19","1","11","3.11"
"109646","13","13","13","0","5","3.11"
"109834","13","13","13","0","10","3.11"
"110182","11","11","9","2","7","3.11"
"110296","10","10","10","0","5","3.11"
"110335","12","12","12","0","8","3.11"
"110819","14","14","12","2","9","3.11"
"110989","17","17","17","0","12","3.11"
"111000","20","20","20","0","13","3.11"
"111054","13","13","11","2","9","3.11"
"111143","17","16","17","0","12","3.11"
"111524","15","15","14","1","11","3.11"
"111576","16","16","14","2","10","3.11"
"111668","21","21","21","0","13","3.11"
"111923","18","18","17","1","16","3.11"
"112485","14","14","12","2","7","3.11"
"112778","13","13","13","0","10","3.11"
"112815","15","15","15","0","12","3.11"
"113297","15","15","14","1","8","3.11"
"113534","24","24","20","4","10","3.11"
"113873","16","16","14","2","13","3.11"
"113992","14","14","13","1","12","3.11"
"114120","15","15","14","1","11","3.11"
"114405","12","12","8","4","7","3.11"
"114533","15","15","12","3","8","3.11"
"114562","15","15","12","3","10","3.11"
"114610","16","16","12","4","11","3.11"
"114626","18","18","15","3","11","3.11"
"114706","18","18","16","2","12","3.11"
"114744","17","17","14","3","11","3.11"
"114963","16","16","12","4","9","3.11"
"115073","11","11","10","1","9","3.11"
"115259","17","17","16","1","13","3.11"
"115384","19","19","17","2","10","3.11"
"115573","15","15","14","1","9","3.11"
"115722","13","13","11","2","6","3.11"
"115772","12","12","10","2","5","3.11"
"115778","17","17","15","2","11","3.11"
"115829","9","9","7","2","5","3.11"
"115850","10","10","9","1","5","3.11"
"115881","14","14","13","1","9","3.11"
"116028","13","13","12","1","12","3.11"
"116474","15","15","14","1","12","3.11"
"116737","18","18","17","1","8","3.11"
"116753","10","10","9","1","8","3.11"
"116756","11","11","10","1","5","3.11"
"100171","12","12","10","2","7","3.10"
"100209","13","13","12","1","7","3.10"
"100355","16","16","14","2","6","3.10"
"100568","14","14","14","0","9","3.10"
"100600","24","24","20","4","12","3.10"
"100645","21","21","19","2","12","3.10"
"100657","11","11","10","1","8","3.10"
"100698","11","11","10","1","7","3.10"
"100814","11","11","11","0","8","3.10"
"100845","16","16","14","2","10","3.10"
"100879","10","10","9","1","7","3.10"
"100925","13","13","12","1","9","3.10"
"101058","9","9","7","2","7","3.10"
"101074","12","12","11","1","6","3.10"
"101187","14","14","13","1","6","3.10"
"101463","15","15","15","0","11","3.10"
"101529","12","12","11","1","9","3.10"
"101582","20","20","18","2","12","3.10"
"101608","12","12","10","2","6","3.10"
"101972","12","12","11","1","7","3.10"
"101973","13","13","9","4","6","3.10"
"101974","20","20","16","4","12","3.10"
"102000","15","15","12","3","7","3.10"
"102239","13","13","11","2","7","3.10"
"102294","17","17","16","1","12","3.10"
"102301","10","10","9","1","6","3.10"
"102450","11","11","10","1","9","3.10"
"102557","17","17","16","1","8","3.10"
"102600","16","16","13","3","10","3.10"
"102651","10","10","9","1","7","3.10"
"102905","8","8","6","2","6","3.10"
"102910","12","12","10","2","6","3.10"
"103045","22","22","20","2","14","3.10"
"103203","11","11","11","0","7","3.10"
"103216","14","14","14","0","8","3.10"
"103547","11","11","10","1","6","3.10"
"103600","10","10","9","1","6","3.10"
"103870","16","16","15","1","12","3.10"
"104047","15","15","12","3","9","3.10"
"104136","11","11","11","0","7","3.10"
"104144","14","14","13","1","7","3.10"
"104186","12","12","10","2","6","3.10"
"104223","10","10","9","1","7","3.10"
"104421","11","11","10","1","6","3.10"
"104439","16","16","14","2","8","3.10"
"104556","11","11","8","3","7","3.10"
"104646","13","13","10","3","6","3.10"
"104886","17","17","15","2","9","3.10"
"105414","20","20","18","2","14","3.10"
"105449","17","17","16","1","11","3.10"
"105613","18","18","18","0","12","3.10"
"105642","10","10","8","2","6","3.10"
"105717","19","19","19","0","13","3.10"
"105805","10","10","10","0","9","3.10"
"105927","21","21","20","1","15","3.10"
"106003","21","21","20","1","9","3.10"
"106064","13","13","11","2","6","3.10"
"106207","12","12","10","2","8","3.10"
"106403","12","12","10","2","6","3.10"
"106635","11","11","11","0","6","3.10"
"106772","14","14","12","2","10","3.10"
"106812","14","14","13","1","6","3.10"
"106827","12","12","10","2","6","3.10"
"106865","21","20","18","3","14","3.10"
"106986","13","13","11","2","7","3.10"
"107071","15","15","12","3","9","3.10"
"107411","15","15","15","0","12","3.10"
"107426","10","10","8","2","7","3.10"
"107490","10","10","9","1","7","3.10"
"107525","15","15","13","2","10","3.10"
"107877","17","17","14","3","13","3.10"
"107993","11","11","10","1","7","3.10"
"108143","14","14","12","2","9","3.10"
"108303","16","16","14","2","9","3.10"
"108342","10","10","7","3","6","3.10"
"108695","18","18","18","0","12","3.10"
"108735","18","18","17","1","13","3.10"
"108817","15","15","15","0","6","3.10"
"109135","16","16","14","2","7","3.10"
"109180","16","16","13","3","8","3.10"
"109237","11","11","10","1","8","3.10"
"109338","14","14","11","3","6","3.10"
"109407","13","13","10","3","6","3.10"
"109719","11","11","9","2","6","3.10"
"109965","14","14","13","1","10","3.10"
"109991","10","10","9","1","6","3.10"
"110040","23","23","22","1","15","3.10"
"110157","17","17","16","1","10","3.10"
"110233","17","17","17","0","12","3.10"
"110258","13","13","10","3","8","3.10"
"110343","11","11","11","0","7","3.10"
"110346","16","16","16","0","8","3.10"
"110353","16","16","15","1","13","3.10"
"110449","13","13","10","3","6","3.10"
"110456","10","10","8","2","7","3.10"
"110757","19","19","15","4","12","3.10"
"110770","7","7","7","0","6","3.10"
"110814","11","11","10","1","7","3.10"
"110900","9","9","8","1","6","3.10"
"111222","15","15","14","1","7","3.10"
"111352","18","18","15","3","10","3.10"
"111356","20","20","16","4","10","3.10"
"111358","12","12","10","2","7","3.10"
"111544","11","11","9","2","6","3.10"
"111570","15","15","13","2","7","3.10"
"111572","16","16","16","0","11","3.10"
"111631","12","12","11","1","7","3.10"
"111657","16","16","15","1","10","3.10"
"111665","11","11","9","2","6","3.10"
"111725","16","16","16","0","12","3.10"
"111732","11","11","11","0","9","3.10"
"111882","11","11","8","3","6","3.10"
"112191","13","13","13","0","6","3.10"
"112241","9","9","8","1","6","3.10"
"112284","9","9","9","0","7","3.10"
"112358","14","14","13","1","11","3.10"
"112380","17","17","16","1","11","3.10"
"112515","19","19","16","3","11","3.10"
"112523","14","14","14","0","11","3.10"
"112682","14","14","13","1","9","3.10"
"112720","9","9","9","0","9","3.10"
"112753","15","15","14","1","10","3.10"
"112944","8","8","6","2","6","3.10"
"112978","8","8","8","0","7","3.10"
"113106","15","15","13","2","11","3.10"
"113170","12","12","11","1","8","3.10"
"113253","17","17","16","1","10","3.10"
"113258","12","12","11","1","6","3.10"
"113478","12","12","12","0","6","3.10"
"113917","15","15","14","1","9","3.10"
"113939","21","21","17","4","12","3.10"
"113958","10","10","8","2","6","3.10"
"114095","10","10","9","1","6","3.10"
"114201","14","14","13","1","9","3.10"
"114391","21","21","20","1","13","3.10"
"114597","12","12","12","0","8","3.10"
"114633","10","10","10","0","6","3.10"
"114635","9","9","9","0","7","3.10"
"114826","13","13","13","0","13","3.10"
"115136","15","15","13","2","11","3.10"
"115151","7","7","7","0","6","3.10"
"115199","15","15","14","1","7","3.10"
"115356","15","15","10","5","6","3.10"
"115679","16","16","13","3","12","3.10"
"115695","10","10","10","0","6","3.10"
"115703","16","16","13","3","7","3.10"
"115817","12","12","10","2","6","3.10"
"115859","8","8","8","0","7","3.10"
"115977","21","21","20","1","13","3.10"
"116036","11","11","10","1","6","3.10"
"116169","10","10","10","0","10","3.10"
"116200","13","13","10","3","9","3.10"
"116256","14","14","14","0","7","3.10"
"116273","12","12","11","1","7","3.10"
"116402","20","20","18","2","11","3.10"
"116532","17","17","16","1","9","3.10"
"116618","17","17","14","3","9","3.10"
"116760","17","17","17","0","12","3.10"
"116834","8","8","8","0","6","3.10"
"117014","12","11","9","3","7","3.10"
"117192","13","13","13","0","6","3.10"
"117206","14","14","14","0","8","3.10"
"101649","19","19","17","2","15","3.09"
"102778","22","22","21","1","15","3.09"
"102903","12","12","11","1","7","3.09"
"105382","22","22","22","0","13","3.09"
"106318","17","17","16","1","12","3.09"
"106546","19","19","17","2","11","3.09"
"106815","23","23","22","1","17","3.09"
"107311","11","11","9","2","5","3.09"
"107713","18","18","16","2","13","3.09"
"108248","22","22","20","2","15","3.09"
"109443","19","19","16","3","12","3.09"
"110239","22","22","20","2","16","3.09"
"110982","24","24","19","5","13","3.09"
"111047","19","19","19","0","13","3.09"
"112144","17","17","17","0","15","3.09"
"113743","15","15","15","0","13","3.09"
"114277","13","13","10","3","8","3.09"
"114490","17","17","16","1","13","3.09"
"114589","21","21","18","3","14","3.09"
"116829","18","18","17","1","13","3.09"
"116976","20","20","18","2","14","3.09"
"117146","15","15","14","1","11","3.09"
"100044","13","13","13","0","9","3.08"
"100070","19","19","17","2","13","3.08"
"100146","14","14","14","0","7","3.08"
"100288","9","9","9","0","6","3.08"
"100362","12","12","10","2","9","3.08"
"100583","16","16","12","4","8","3.08"
"100602","13","13","11","2","9","3.08"
"100696","21","21","20","1","10","3.08"
"100722","15","15","13","2","9","3.08"
"100794","15","15","14","1","10","3.08"
"100834","13","13","12","1","8","3.08"
"100864","9","9","8","1","6","3.08"
"100929","12","12","11","1","7","3.08"
"100945","16","16","15","1","9","3.08"
"100987","19","19","15","4","11","3.08"
"101027","18","18","18","0","12","3.08"
"101153","15","15","13","2","7","3.08"
"101177","11","11","11","0","8","3.08"
"101243","15","15","13","2","10","3.08"
"101387","12","12","11","1","7","3.08"
"101430","14","14","11","3","8","3.08"
"101435","21","21","20","1","16","3.08"
"101496","19","19","19","0","12","3.08"
"101657","16","16","13","3","10","3.08"
"101682","13","13","9","4","7","3.08"
"101825","12","12","9","3","8","3.08"
"101838","15","15","14","1","10","3.08"
"101943","9","9","9","0","7","3.08"
"102140","16","16","15","1","10","3.08"
"102214","20","20","17","3","14","3.08"
"102226","16","16","15","1","10","3.08"
"102285","15","15","15","0","11","3.08"
"102291","11","11","10","1","7","3.08"
"102364","14","14","12","2","8","3.08"
"102511","18","18","16","2","9","3.08"
"102548","15","15","14","1","9","3.08"
"102704","12","12","11","1","10","3.08"
"102983","11","11","10","1","9","3.08"
"103115","22","22","18","4","10","3.08"
"103268","15","15","12","3","7","3.08"
"103275","11","11","11","0","11","3.08"
"103310","11","11","9","2","7","3.08"
"103311","13","13","13","0","9","3.08"
"103481","13","13","13","0","9","3.08"
"103512","16","15","15","1","6","3.08"
"103524","16","16","15","1","9","3.08"
"103672","14","14","13","1","7","3.08"
"103708","23","23","22","1","14","3.08"
"103758","11","11","10","1","8","3.08"
"103874","13","13","13","0","9","3.08"
"103904","17","17","17","0","13","3.08"
"104226","15","15","14","1","12","3.08"
"104553","16","16","14","2","9","3.08"
"104584","16","16","14","2","10","3.08"
"104619","15","15","14","1","7","3.08"
"104690","14","14","13","1","9","3.08"
"104809","16","16","14","2","8","3.08"
"104858","15","15","15","0","13","3.08"
"105219","12","12","10","2","7","3.08"
"105320","20","20","19","1","13","3.08"
"105770","15","15","14","1","9","3.08"
"105778","10","10","10","0","7","3.08"
"106098","10","10","9","1","7","3.08"
"106146","13","13","12","1","7","3.08"
"106305","12","12","10","2","7","3.08"
"106468","13","13","12","1","8","3.08"
"106707","21","21","19","2","15","3.08"
"106754","10","10","9","1","7","3.08"
"106892","10","10","10","0","6","3.08"
"107093","10","10","8","2","6","3.08"
"107288","13","13","12","1","9","3.08"
"107339","19","19","17","2","12","3.08"
"107587","14","14","12","2","8","3.08"
"107604","21","21","20","1","13","3.08"
"107701","14","14","12","2","8","3.08"
"107797","14","14","13","1","8","3.08"
"107899","11","11","10","1","9","3.08"
"107989","11","11","10","1","6","3.08"
"108013","8","8","7","1","6","3.08"
"108045","15","15","13","2","10","3.08"
"108066","12","12","9","3","8","3.08"
"108068","16","16","14","2","7","3.08"
"108137","11","11","9","2","7","3.08"
"108193","14","14","11","3","8","3.08"
"108336","14","14","11","3","7","3.08"
"108459","15","15","13","2","9","3.08"
"108493","15","15","12","3","7","3.08"
"108524","14","14","14","0","6","3.08"
"108551","11","11","11","0","8","3.08"
"108710","22","22","22","0","15","3.08"
"108773","11","11","11","0","7","3.08"
"108855","14","14","13","1","9","3.08"
"108905","18","18","16","2","9","3.08"
"109045","13","13","11","2","7","3.08"
"109052","13","13","10","3","7","3.08"
"109188","10","10","10","0","8","3.08"
"109593","16","16","15","1","10","3.08"
"110070","14","14","11","3","9","3.08"
"110305","18","18","15","3","9","3.08"
"110423","13","13","13","0","8","3.08"
"110481","13","13","12","1","9","3.08"
"110636","13","13","12","1","9","3.08"
"110692","11","11","10","1","7","3.08"
"110855","13","13","12","1","9","3.08"
"110892","22","22","21","1","15","3.08"
"110949","13","13","11","2","7","3.08"
"111088","9","9","8","1","7","3.08"
"111188","12","12","12","0","10","3.08"
"111242","12","12","12","0","9","3.08"
"111273","13","13","12","1","10","3.08"
"111353","17","17","15","2","9","3.08"
"111419","10","10","9","1","7","3.08"
"111456","13","13","13","0","10","3.08"
"111596","11","11","9","2","6","3.08"
"111800","19","19","16","3","9","3.08"
"111878","12","12","12","0","8","3.08"
"112659","15","15","14","1","11","3.08"
"112799","15","15","15","0","13","3.08"
"112931","17","17","15","2","8","3.08"
"112969","17","17","14","3","9","3.08"
"113082","12","12","12","0","7","3.08"
"113119","13","13","10","3","7","3.08"
"113355","8","8","7","1","6","3.08"
"113380","13","13","9","4","6","3.08"
"113390","15","15","15","0","13","3.08"
"113444","11","11","11","0","7","3.08"
"113452","13","13","11","2","8","3.08"
"113475","16","16","13","3","9","3.08"
"113671","18","18","15","3","11","3.08"
"113715","16","16","15","1","10","3.08"
"113767","9","9","8","1","7","3.08"
"113778","12","12","12","0","7","3.08"
"113806","17","17","16","1","9","3.08"
"113846","16","16","13","3","9","3.08"
"114101","13","13","12","1","9","3.08"
"114300","15","15","12","3","9","3.08"
"114314","14","14","14","0","9","3.08"
"114443","13","13","13","0","8","3.08"
"114460","12","12","11","1","7","3.08"
"114566","11","11","9","2","7","3.08"
"114781","16","16","14","2","9","3.08"
"114911","16","16","15","1","12","3.08"
"114927","18","18","15","3","7","3.08"
"115041","14","14","14","0","8","3.08"
"115103","15","15","13","2","6","3.08"
"115104","12","12","11","1","10","3.08"
"115110","14","14","13","1","8","3.08"
"115129","14","14","11","3","9","3.08"
"115139","10","10","7","3","7","3.08"
"115251","16","16","13","3","9","3.08"
"115300","13","12","11","2","10","3.08"
"115331","16","16","15","1","12","3.08"
"115600","18","18","15","3","8","3.08"
"115645","13","13","12","1","6","3.08"
"115754","14","14","13","1","10","3.08"
"115767","15","15","15","0","8","3.08"
"115793","16","16","14","2","8","3.08"
"115876","14","14","14","0","13","3.08"
"115887","14","14","12","2","9","3.08"
"115890","14","14","12","2","6","3.08"
"116043","15","15","14","1","7","3.08"
"116223","17","17","13","4","8","3.08"
"116309","16","16","14","2","13","3.08"
"116367","19","19","16","3","12","3.08"
"116410","11","11","10","1","7","3.08"
"116427","11","11","8","3","6","3.08"
"116482","11","11","9","2","8","3.08"
"116671","13","13","12","1","9","3.08"
"116994","15","15","11","4","8","3.08"
"117144","18","18","18","0","14","3.08"
"117264","14","14","12","2","8","3.08"
"117580","14","14","12","2","9","3.08"
"100161","17","17","16","1","10","3.07"
"100271","13","13","11","2","9","3.07"
"100432","17","17","16","1","11","3.07"
"100464","11","11","11","0","9","3.07"
"100483","16","16","15","1","9","3.07"
"100560","16","16","16","0","11","3.07"
"100631","14","14","13","1","9","3.07"
"100848","17","16","14","3","12","3.07"
"100962","12","12","12","0","9","3.07"
"100971","13","13","11","2","7","3.07"
"101122","11","11","10","1","7","3.07"
"101219","14","14","14","0","10","3.07"
"101400","17","17","14","3","12","3.07"
"101638","14","14","14","0","8","3.07"
"101897","16","16","15","1","13","3.07"
"101920","15","15","14","1","10","3.07"
"101947","12","12","12","0","9","3.07"
"102217","18","18","15","3","8","3.07"
"102509","15","15","15","0","10","3.07"
"102579","19","18","18","1","16","3.07"
"102765","18","18","16","2","10","3.07"
"102835","16","16","15","1","11","3.07"
"102897","14","14","14","0","9","3.07"
"103037","11","11","10","1","8","3.07"
"103070","15","15","12","3","9","3.07"
"103347","12","12","12","0","8","3.07"
"103456","12","11","11","1","10","3.07"
"103567","17","17","15","2","12","3.07"
"103735","12","12","12","0","8","3.07"
"103826","15","15","15","0","12","3.07"
"104163","16","16","13","3","10","3.07"
"104272","11","11","11","0","8","3.07"
"104338","15","15","12","3","7","3.07"
"104453","21","21","19","2","13","3.07"
"104460","17","17","15","2","9","3.07"
"104740","13","13","12","1","11","3.07"
"104870","18","18","16","2","12","3.07"
"104881","12","12","11","1","9","3.07"
"105108","16","16","15","1","9","3.07"
"105234","19","19","17","2","9","3.07"
"105309","11","11","11","0","8","3.07"
"105324","14","14","13","1","7","3.07"
"105383","17","17","15","2","12","3.07"
"105444","14","14","11","3","10","3.07"
"105479","13","13","12","1","11","3.07"
"105516","13","13","13","0","7","3.07"
"105679","16","16","11","5","9","3.07"
"105783","18","18","13","5","10","3.07"
"105875","14","14","14","0","9","3.07"
"105891","13","13","11","2","9","3.07"
"105919","20","20","19","1","11","3.07"
"105960","14","14","12","2","9","3.07"
"106017","16","16","16","0","12","3.07"
"106120","13","13","11","2","9","3.07"
"106138","15","15","13","2","9","3.07"
"106278","12","12","12","0","8","3.07"
"106285","14","14","14","0","10","3.07"
"106317","17","17","16","1","14","3.07"
"106542","11","11","10","1","8","3.07"
"106559","10","10","9","1","8","3.07"
"106663","12","12","9","3","8","3.07"
"106664","12","12","11","1","10","3.07"
"107046","18","17","17","1","12","3.07"
"107064","13","13","11","2","9","3.07"
"107154","17","17","16","1","11","3.07"
"107165","13","13","12","1","7","3.07"
"107186","21","21","18","3","12","3.07"
"107244","15","15","13","2","9","3.07"
"107501","15","15","14","1","9","3.07"
"107984","19","19","16","3","13","3.07"
"108321","11","11","10","1","8","3.07"
"108374","16","16","15","1","11","3.07"
"108404","15","15","12","3","9","3.07"
"108423","17","17","15","2","12","3.07"
"108557","13","13","12","1","8","3.07"
"108613","14","14","14","0","11","3.07"
"108648","14","14","14","0","13","3.07"
"108703","22","22","20","2","17","3.07"
"108863","10","10","10","0","8","3.07"
"108889","17","17","14","3","12","3.07"
"108994","9","9","8","1","7","3.07"
"109008","17","17","16","1","11","3.07"
"109032","17","17","15","2","9","3.07"
"109069","14","14","12","2","10","3.07"
"109123","16","16","14","2","8","3.07"
"109136","20","20","19","1","15","3.07"
"109254","15","15","15","0","9","3.07"
"109811","12","12","12","0","10","3.07"
"109923","16","16","14","2","11","3.07"
"110110","14","14","13","1","9","3.07"
"110132","14","14","13","1","9","3.07"
"110250","19","19","16","3","10","3.07"
"110283","16","16","13","3","8","3.07"
"110292","12","12","11","1","9","3.07"
"110600","17","17","15","2","11","3.07"
"110626","14","14","14","0","8","3.07"
"110705","20","20","16","4","12","3.07"
"111348","9","9","9","0","9","3.07"
"111530","13","13","12","1","11","3.07"
"111794","15","15","14","1","9","3.07"
"111836","19","19","16","3","11","3.07"
"112026","19","19","16","3","13","3.07"
"112242","12","12","10","2","8","3.07"
"112313","15","15","14","1","10","3.07"
"112354","19","19","17","2","13","3.07"
"112489","20","20","16","4","12","3.07"
"112561","16","16","14","2","8","3.07"
"112703","11","11","9","2","7","3.07"
"113085","10","10","9","1","8","3.07"
"113113","17","17","14","3","8","3.07"
"113171","13","13","13","0","12","3.07"
"113296","21","21","21","0","14","3.07"
"113443","11","11","11","0","8","3.07"
"113451","20","20","16","4","10","3.07"
"113488","13","13","12","1","7","3.07"
"113505","17","17","16","1","12","3.07"
"113558","18","18","16","2","10","3.07"
"113594","14","14","10","4","7","3.07"
"113657","18","18","17","1","10","3.07"
"113692","14","14","14","0","8","3.07"
"113748","11","11","10","1","7","3.07"
"113874","11","11","11","0","9","3.07"
"113982","14","14","13","1","12","3.07"
"113988","18","18","15","3","10","3.07"
"114002","16","16","16","0","9","3.07"
"114173","13","13","11","2","10","3.07"
"114205","11","11","11","0","9","3.07"
"114620","18","18","18","0","11","3.07"
"115120","19","19","17","2","12","3.07"
"115149","19","19","17","2","14","3.07"
"115160","17","17","16","1","12","3.07"
"115231","16","16","14","2","12","3.07"
"115290","17","17","12","5","8","3.07"
"115315","12","12","10","2","8","3.07"
"115352","14","14","12","2","8","3.07"
"115373","14","14","13","1","11","3.07"
"115627","17","17","15","2","10","3.07"
"115693","17","17","17","0","8","3.07"
"115718","15","15","15","0","12","3.07"
"116065","13","13","10","3","8","3.07"
"116298","16","16","15","1","9","3.07"
"116303","13","12","13","0","10","3.07"
"116461","10","10","10","0","9","3.07"
"116556","15","15","14","1","8","3.07"
"116561","16","16","15","1","9","3.07"
"116714","21","21","17","4","10","3.07"
"116730","17","17","15","2","10","3.07"
"116832","14","14","13","1","12","3.07"
"117145","15","15","14","1","11","3.07"
"117179","13","13","12","1","9","3.07"
"117255","11","11","10","1","8","3.07"
"117365","19","19","18","1","13","3.07"
"117396","13","13","13","0","11","3.07"
"117431","15","15","11","4","9","3.07"
"117466","22","22","18","4","9","3.07"
"117548","11","11","11","0","9","3.07"
"117620","16","16","15","1","13","3.07"
"100294","13","13","8","5","8","3.06"
"100476","21","21","17","4","12","3.06"
"100487","17","17","15","2","12","3.06"
"100888","13","13","13","0","10","3.06"
"101008","21","21","21","0","19","3.06"
"101087","13","13","13","0","11","3.06"
"101242","16","16","14","2","9","3.06"
"101292","17","17","15","2","11","3.06"
"101478","18","18","16","2","10","3.06"
"101585","16","16","16","0","13","3.06"
"101885","19","19","15","4","10","3.06"
"101942","21","21","18","3","12","3.06"
"102181","17","17","14","3","10","3.06"
"102307","14","14","14","0","8","3.06"
"102341","13","13","13","0","10","3.06"
"102616","20","20","17","3","13","3.06"
"102652","18","18","17","1","14","3.06"
"102714","17","17","16","1","10","3.06"
"102728","16","16","16","0","11","3.06"
"102836","18","18","16","2","11","3.06"
"102846","14","14","13","1","10","3.06"
"102848","14","14","13","1","10","3.06"
"102982","16","16","14","2","10","3.06"
"102988","16","16","15","1","11","3.06"
"103085","14","14","13","1","11","3.06"
"103391","16","16","14","2","10","3.06"
"103462","18","18","16","2","8","3.06"
"103519","20","20","20","0","13","3.06"
"103551","10","10","9","1","6","3.06"
"103635","10","10","9","1","8","3.06"
"103644","18","18","16","2","11","3.06"
"103651","18","18","18","0","13","3.06"
"103751","17","17","16","1","10","3.06"
"103956","13","13","13","0","11","3.06"
"104104","11","11","9","2","8","3.06"
"104281","13","13","12","1","8","3.06"
"104299","20","20","18","2","13","3.06"
"104309","16","16","14","2","11","3.06"
"104324","14","14","13","1","9","3.06"
"104437","12","12","10","2","8","3.06"
"104454","23","23","20","3","12","3.06"
"104862","18","18","17","1","12","3.06"
"105022","15","15","13","2","10","3.06"
"105179","11","11","11","0","10","3.06"
"105480","18","18","17","1","14","3.06"
"105526","18","18","18","0","13","3.06"
"105646","13","13","12","1","9","3.06"
"105677","13","13","11","2","9","3.06"
"105713","22","22","20","2","14","3.06"
"106045","16","16","14","2","10","3.06"
"106182","16","16","14","2","11","3.06"
"106191","17","17","16","1","13","3.06"
"106271","13","13","13","0","9","3.06"
"106393","14","14","13","1","10","3.06"
"106460","21","21","19","2","10","3.06"
"106482","14","14","11","3","11","3.06"
"106538","17","17","17","0","12","3.06"
"106708","11","11","11","0","10","3.06"
"106817","18","18","16","2","13","3.06"
"106855","17","17","15","2","11","3.06"
"107173","14","14","14","0","10","3.06"
"107214","11","11","11","0","9","3.06"
"107218","16","16","15","1","11","3.06"
"107276","14","14","11","3","9","3.06"
"107934","16","16","15","1","9","3.06"
"108033","21","21","17","4","15","3.06"
"108586","21","21","20","1","9","3.06"
"108678","11","11","10","1","9","3.06"
"108809","14","14","12","2","9","3.06"
"108923","14","14","13","1","11","3.06"
"108969","18","18","18","0","11","3.06"
"109352","16","16","14","2","9","3.06"
"109532","19","19","16","3","12","3.06"
"109655","21","21","19","2","13","3.06"
"109840","14","14","14","0","11","3.06"
"109979","12","12","12","0","11","3.06"
"110008","15","15","14","1","12","3.06"
"110185","18","18","18","0","11","3.06"
"110260","15","15","13","2","11","3.06"
"110497","14","14","14","0","12","3.06"
"110517","16","16","14","2","9","3.06"
"110737","13","12","12","1","10","3.06"
"110877","14","14","14","0","8","3.06"
"111275","13","13","13","0","11","3.06"
"111435","15","15","13","2","12","3.06"
"111616","19","19","19","0","15","3.06"
"112293","14","14","13","1","9","3.06"
"112416","19","19","18","1","11","3.06"
"112496","13","13","12","1","11","3.06"
"112570","16","16","14","2","11","3.06"
"112765","19","19","17","2","14","3.06"
"112836","15","15","15","0","9","3.06"
"112896","16","16","14","2","14","3.06"
"112917","20","20","17","3","11","3.06"
"113157","27","27","22","5","15","3.06"
"113504","14","14","12","2","9","3.06"
"113728","17","17","16","1","11","3.06"
"113809","14","14","11","3","9","3.06"
"114109","18","18","18","0","16","3.06"
"114163","13","13","13","0","10","3.06"
"114197","20","20","15","5","13","3.06"
"114198","11","11","11","0","9","3.06"
"114286","8","8","7","1","6","3.06"
"114406","19","19","18","1","14","3.06"
"114470","18","18","13","5","10","3.06"
"114522","17","17","15","2","13","3.06"
"114824","13","13","12","1","6","3.06"
"114957","22","22","22","0","14","3.06"
"115144","18","18","18","0","13","3.06"
"115233","16","16","12","4","9","3.06"
"115250","17","17","15","2","12","3.06"
"115323","16","16","15","1","11","3.06"
"115696","17","17","17","0","13","3.06"
"115700","22","22","20","2","17","3.06"
"115769","15","15","12","3","8","3.06"
"115873","16","16","15","1","13","3.06"
"116005","17","17","16","1","14","3.06"
"116039","13","13","12","1","9","3.06"
"116089","15","15","14","1","11","3.06"
"116287","15","15","13","2","10","3.06"
"116549","17","17","16","1","14","3.06"
"116986","10","10","10","0","8","3.06"
"117007","14","14","12","2","9","3.06"
"117170","14","14","14","0","10","3.06"
"117246","15","15","11","4","8","3.06"
"117460","15","15","15","0","10","3.06"
"117567","16","16","15","1","11","3.06"
"100000","21","21","19","2","16","3.05"
"100521","18","18","16","2","13","3.05"
"100586","14","14","13","1","11","3.05"
"100712","18","18","16","2","12","3.05"
"101432","15","15","15","0","11","3.05"
"101924","14","14","11","3","8","3.05"
"102005","14","14","13","1","10","3.05"
"102536","14","14","13","1","11","3.05"
"102544","15","15","14","1","8","3.05"
"102684","13","13","13","0","11","3.05"
"102699","12","12","11","1","9","3.05"
"102980","14","14","12","2","8","3.05"
"103561","19","19","18","1","9","3.05"
"103794","19","19","18","1","16","3.05"
"103812","15","15","13","2","10","3.05"
"103914","17","17","16","1","10","3.05"
"104038","15","15","14","1","9","3.05"
"104400","18","18","15","3","13","3.05"
"104461","14","14","12","2","12","3.05"
"104711","17","17","17","0","14","3.05"
"104854","16","16","15","1","12","3.05"
"104919","16","16","14","2","9","3.05"
"105427","16","16","15","1","10","3.05"
"105675","14","14","10","4","9","3.05"
"105806","22","22","20","2","15","3.05"
"105817","21","21","17","4","11","3.05"
"105933","17","17","16","1","11","3.05"
"106042","14","14","13","1","11","3.05"
"106237","23","23","21","2","12","3.05"
"106822","16","16","16","0","11","3.05"
"107937","16","16","14","2","10","3.05"
"108077","14","14","13","1","11","3.05"
"108384","18","18","18","0","9","3.05"
"108427","11","11","9","2","8","3.05"
"110944","22","22","21","1","19","3.05"
"111785","19","19","19","0","14","3.05"
"111873","16","16","14","2","11","3.05"
"111965","19","19","17","2","11","3.05"
"111987","18","18","16","2","10","3.05"
"112632","14","14","14","0","11","3.05"
"113078","22","22","21","1","11","3.05"
"113598","23","23","22","1","16","3.05"
"113991","16","16","16","0","12","3.05"
"114262","17","17","14","3","9","3.05"
"114315","15","15","14","1","12","3.05"
"114568","18","18","15","3","13","3.05"
"114687","16","16","14","2","12","3.05"
"115467","13","13","12","1","10","3.05"
"115580","17","16","17","0","15","3.05"
"115647","17","17","17","0","11","3.05"
"115802","17","17","17","0","12","3.05"
"116489","15","15","13","2","9","3.05"
"116586","12","12","12","0","9","3.05"
"100652","18","18","15","3","13","3.04"
"100708","16","16","15","1","13","3.04"
"100946","20","20","19","1","14","3.04"
"101589","13","13","12","1","9","3.04"
"102299","18","18","16","2","14","3.04"
"102686","14","14","11","3","7","3.04"
"102829","17","17","16","1","15","3.04"
"103223","16","16","15","1","10","3.04"
"103316","24","24","22","2","15","3.04"
"103486","17","17","15","2","11","3.04"
"103784","22","22","21","1","16","3.04"
"105160","17","17","16","1","12","3.04"
"105533","17","17","16","1","12","3.04"
"105929","19","19","18","1","11","3.04"
"106072","16","16","13","3","11","3.04"
"106656","14","14","13","1","11","3.04"
"106836","14","14","11","3","7","3.04"
"107515","15","15","13","2","8","3.04"
"107594","21","21","18","3","13","3.04"
"107790","12","12","12","0","9","3.04"
"108049","19","19","19","0","12","3.04"
"108245","23","23","22","1","16","3.04"
"108788","16","16","16","0","10","3.04"
"108916","22","22","20","2","14","3.04"
"108986","15","15","13","2","10","3.04"
"109114","15","15","13","2","11","3.04"
"109190","18","18","16","2","11","3.04"
"109427","19","19","16","3","12","3.04"
"109689","15","15","13","2","10","3.04"
"110208","18","18","18","0","13","3.04"
"110217","22","22","19","3","15","3.04"
"110365","18","18","17","1","13","3.04"
"110382","11","11","10","1","9","3.04"
"110522","17","17","15","2","11","3.04"
"110631","15","15","13","2","8","3.04"
"111190","18","18","15","3","12","3.04"
"111316","22","22","19","3","15","3.04"
"111757","27","27","23","4","13","3.04"
"111817","15","15","12","3","10","3.04"
"112132","19","19","19","0","15","3.04"
"112335","22","22","19","3","14","3.04"
"112432","16","16","13","3","10","3.04"
"112631","18","18","18","0","13","3.04"
"112660","15","15","13","2","12","3.04"
"113532","12","12","11","1","10","3.04"
"113709","18","18","18","0","12","3.04"
"113797","19","19","19","0","12","3.04"
"113881","16","16","13","3","10","3.04"
"114556","20","20","18","2","13","3.04"
"114579","19","19","18","1","15","3.04"
"114745","15","15","11","4","9","3.04"
"114887","20","20","19","1","14","3.04"
"115294","20","20","15","5","10","3.04"
"115311","15","15","14","1","11","3.04"
"116001","16","16","15","1","13","3.04"
"116186","14","14","13","1","11","3.04"
"116297","15","15","15","0","10","3.04"
"116729","17","17","15","2","14","3.04"
"117525","18","18","17","1","13","3.04"
"117533","19","19","16","3","7","3.04"
"100059","16","16","15","1","11","3.03"
"100532","14","14","13","1","9","3.03"
"100590","22","22","21","1","16","3.03"
"100594","14","14","12","2","8","3.03"
"100660","16","16","15","1","11","3.03"
"100765","18","18","16","2","9","3.03"
"100890","15","15","14","1","12","3.03"
"101092","18","18","16","2","13","3.03"
"101211","19","19","16","3","9","3.03"
"101599","15","15","14","1","9","3.03"
"101816","19","19","18","1","13","3.03"
"103229","19","19","18","1","10","3.03"
"103852","12","12","11","1","8","3.03"
"104266","17","17","14","3","9","3.03"
"104411","22","22","21","1","15","3.03"
"104716","18","18","15","3","10","3.03"
"105247","17","17","14","3","9","3.03"
"105757","13","13","12","1","8","3.03"
"106015","20","20","18","2","14","3.03"
"106623","16","16","14","2","9","3.03"
"107617","14","14","13","1","9","3.03"
"107729","15","15","13","2","13","3.03"
"107785","14","14","14","0","11","3.03"
"108200","15","15","14","1","8","3.03"
"108302","18","18","18","0","12","3.03"
"108843","12","12","12","0","12","3.03"
"109793","15","15","13","2","10","3.03"
"109911","12","12","10","2","9","3.03"
"110398","14","14","14","0","11","3.03"
"110623","13","13","13","0","11","3.03"
"110875","14","14","13","1","11","3.03"
"110958","19","18","17","2","12","3.03"
"111284","11","11","10","1","8","3.03"
"111512","14","14","13","1","10","3.03"
"112853","17","17","16","1","11","3.03"
"113121","18","18","16","2","10","3.03"
"113298","12","12","11","1","8","3.03"
"113305","16","16","14","2","12","3.03"
"113724","13","13","12","1","8","3.03"
"113856","17","17","14","3","10","3.03"
"114081","14","14","11","3","9","3.03"
"114177","22","22","19","3","15","3.03"
"115607","15","15","15","0","10","3.03"
"115662","18","18","17","1","15","3.03"
"115755","13","13","12","1","8","3.03"
"115795","17","17","16","1","12","3.03"
"116046","16","16","13","3","13","3.03"
"116074","18","18","16","2","12","3.03"
"116116","16","16","16","0","12","3.03"
"116243","15","15","13","2","8","3.03"
"116432","21","21","20","1","15","3.03"
"100693","16","16","16","0","11","3.02"
"102520","26","26","24","2","21","3.02"
"102589","19","19","15","4","11","3.02"
"102706","12","12","11","1","10","3.02"
"103235","19","19","18","1","11","3.02"
"103325","17","17","15","2","13","3.02"
"103773","22","22","21","1","14","3.02"
"104206","21","21","17","4","10","3.02"
"104212","15","15","14","1","11","3.02"
"104527","23","23","21","2","12","3.02"
"104594","17","17","14","3","11","3.02"
"104686","21","21","19","2","13","3.02"
"104796","12","12","11","1","11","3.02"
"104922","16","16","14","2","10","3.02"
"105624","15","15","14","1","11","3.02"
"105690","17","17","16","1","13","3.02"
"105909","17","17","14","3","10","3.02"
"106125","16","16","14","2","13","3.02"
"108218","19","19","19","0","14","3.02"
"108346","14","14","14","0","11","3.02"
"108441","13","13","13","0","10","3.02"
"109043","16","16","15","1","12","3.02"
"109151","21","21","20","1","14","3.02"
"109660","19","19","19","0","12","3.02"
"110051","17","17","15","2","11","3.02"
"110137","22","21","21","1","15","3.02"
"111093","26","26","20","6","16","3.02"
"111393","14","14","13","1","12","3.02"
"111626","21","21","20","1","16","3.02"
"112670","14","14","14","0","12","3.02"
"113256","16","16","15","1","12","3.02"
"113980","16","16","14","2","11","3.02"
"114047","20","20","19","1","14","3.02"
"114226","14","14","13","1","11","3.02"
"115571","16","16","14","2","13","3.02"
"116887","21","21","17","4","12","3.02"
"117138","19","18","19","0","15","3.02"
"117284","18","18","18","0","12","3.02"
"102060","21","21","21","0","15","3.01"
"106450","20","20","19","1","14","3.01"
"107512","22","22","21","1","13","3.01"
"107753","23","23","20","3","18","3.01"
"110500","20","20","19","1","14","3.01"
"113684","24","24","24","0","16","3.01"
"117008","19","19","18","1","15","3.01"
"100012","14","14","13","1","6","3.00"
"100030","10","10","9","1","8","3.00"
"100043","14","14","14","0","8","3.00"
"100046","11","11","11","0","9","3.00"
"100083","9","9","7","2","2","3.00"
"100118","15","15","14","1","11","3.00"
"100128","9","9","9","0","8","3.00"
"100130","10","10","10","0","2","3.00"
"100151","13","13","11","2","6","3.00"
"100155","16","16","15","1","8","3.00"
"100178","14","14","14","0","7","3.00"
"100194","14","14","11","3","5","3.00"
"100208","9","9","7","2","6","3.00"
"100224","16","16","12","4","10","3.00"
"100279","6","6","6","0","3","3.00"
"100298","7","7","5","2","3","3.00"
"100341","6","6","5","1","4","3.00"
"100348","15","15","14","1","7","3.00"
"100366","13","13","12","1","7","3.00"
"100377","14","14","13","1","7","3.00"
"100404","7","7","6","1","4","3.00"
"100430","15","15","13","2","12","3.00"
"100431","10","10","9","1","8","3.00"
"100437","13","13","13","0","7","3.00"
"100439","5","5","4","1","2","3.00"
"100478","16","16","15","1","8","3.00"
"100500","13","13","10","3","5","3.00"
"100511","7","7","7","0","6","3.00"
"100533","14","14","13","1","6","3.00"
"100553","13","13","11","2","9","3.00"
"100601","19","19","16","3","10","3.00"
"100613","7","7","7","0","5","3.00"
"100666","12","12","12","0","9","3.00"
"100704","12","12","10","2","6","3.00"
"100760","19","19","19","0","12","3.00"
"100777","12","12","11","1","3","3.00"
"100781","9","9","8","1","6","3.00"
"100788","10","10","9","1","5","3.00"
"100792","13","13","13","0","10","3.00"
"100793","11","11","11","0","4","3.00"
"100795","11","11","10","1","4","3.00"
"100812","16","16","15","1","9","3.00"
"100813","17","17","14","3","9","3.00"
"100852","8","8","6","2","6","3.00"
"100863","12","12","10","2","8","3.00"
"100895","14","14","12","2","9","3.00"
"100896","17","17","15","2","9","3.00"
"100942","10","10","9","1","5","3.00"
"100964","7","7","5","2","2","3.00"
"100995","10","10","9","1","7","3.00"
"101015","13","13","11","2","8","3.00"
"101016","13","13","12","1","7","3.00"
"101022","7","7","6","1","3","3.00"
"101026","14","14","12","2","9","3.00"
"101033","8","8","8","0","7","3.00"
"101039","16","16","15","1","9","3.00"
"101041","14","14","12","2","6","3.00"
"101078","16","16","13","3","9","3.00"
"101088","11","11","11","0","7","3.00"
"101107","14","14","14","0","8","3.00"
"101116","13","13","13","0","10","3.00"
"101121","7","7","6","1","6","3.00"
"101136","22","22","21","1","11","3.00"
"101180","12","12","11","1","8","3.00"
"101206","9","9","8","1","5","3.00"
"101216","15","15","12","3","5","3.00"
"101220","11","11","10","1","4","3.00"
"101222","10","10","9","1","9","3.00"
"101259","14","14","11","3","2","3.00"
"101288","16","16","13","3","7","3.00"
"101314","6","6","6","0","3","3.00"
"101376","9","9","8","1","4","3.00"
"101428","12","12","11","1","6","3.00"
"101433","12","12","9","3","7","3.00"
"101467","13","13","12","1","10","3.00"
"101484","13","13","13","0","7","3.00"
"101602","11","11","10","1","6","3.00"
"101607","14","14","13","1","7","3.00"
"101610","15","15","14","1","8","3.00"
"101671","13","13","11","2","4","3.00"
"101681","6","6","5","1","3","3.00"
"101705","16","16","14","2","10","3.00"
"101718","11","11","8","3","7","3.00"
"101753","15","15","11","4","6","3.00"
"101762","16","16","14","2","12","3.00"
"101768","16","16","13","3","8","3.00"
"101778","13","13","11","2","8","3.00"
"101804","15","15","11","4","7","3.00"
"101829","14","14","13","1","10","3.00"
"101845","10","10","10","0","6","3.00"
"101859","17","17","13","4","7","3.00"
"101862","4","4","4","0","3","3.00"
"101890","19","18","19","0","16","3.00"
"101892","14","14","14","0","8","3.00"
"101895","8","8","7","1","5","3.00"
"101910","17","17","14","3","6","3.00"
"101940","22","22","19","3","10","3.00"
"101952","10","10","9","1","5","3.00"
"101963","22","22","21","1","13","3.00"
"102052","16","16","16","0","10","3.00"
"102091","13","13","13","0","8","3.00"
"102100","10","10","10","0","8","3.00"
"102127","13","13","12","1","10","3.00"
"102129","10","10","10","0","8","3.00"
"102161","10","10","9","1","3","3.00"
"102167","17","17","15","2","11","3.00"
"102207","6","6","4","2","2","3.00"
"102222","8","8","6","2","5","3.00"
"102238","17","17","17","0","14","3.00"
"102265","12","12","10","2","5","3.00"
"102273","12","12","11","1","5","3.00"
"102280","15","15","13","2","11","3.00"
"102394","5","5","5","0","4","3.00"
"102407","7","7","5","2","5","3.00"
"102418","10","10","8","2","7","3.00"
"102421","7","7","6","1","5","3.00"
"102422","18","18","16","2","12","3.00"
"102436","13","13","10","3","7","3.00"
"102473","10","10","7","3","6","3.00"
"102513","10","10","8","2","5","3.00"
"102515","16","16","14","2","12","3.00"
"102521","13","13","12","1","8","3.00"
"102543","12","12","11","1","6","3.00"
"102584","14","14","14","0","6","3.00"
"102605","10","10","8","2","5","3.00"
"102610","7","7","6","1","6","3.00"
"102622","14","14","13","1","8","3.00"
"102644","20","20","17","3","12","3.00"
"102658","14","14","12","2","9","3.00"
"102663","9","9","8","1","2","3.00"
"102666","10","10","9","1","3","3.00"
"102707","13","13","13","0","7","3.00"
"102736","10","10","9","1","4","3.00"
"102748","10","10","8","2","6","3.00"
"102769","12","12","11","1","10","3.00"
"102788","18","18","17","1","15","3.00"
"102807","23","23","21","2","13","3.00"
"102851","8","8","6","2","4","3.00"
"102873","12","12","11","1","9","3.00"
"102885","15","15","15","0","12","3.00"
"102888","18","18","18","0","9","3.00"
"102894","15","15","11","4","9","3.00"
"102972","9","9","9","0","6","3.00"
"102986","14","14","12","2","7","3.00"
"103007","10","10","10","0","4","3.00"
"103040","16","16","15","1","10","3.00"
"103041","13","13","13","0","9","3.00"
"103068","13","13","11","2","9","3.00"
"103071","11","11","9","2","8","3.00"
"103113","12","12","9","3","5","3.00"
"103126","15","15","13","2","12","3.00"
"103141","12","12","11","1","7","3.00"
"103188","13","13","12","1","8","3.00"
"103236","11","11","10","1","3","3.00"
"103239","10","10","8","2","3","3.00"
"103241","13","13","10","3","6","3.00"
"103249","10","10","9","1","7","3.00"
"103267","9","9","8","1","4","3.00"
"103269","14","14","10","4","7","3.00"
"103367","15","15","15","0","10","3.00"
"103377","10","10","7","3","4","3.00"
"103466","21","21","19","2","10","3.00"
"103478","10","10","9","1","3","3.00"
"103483","10","10","7","3","4","3.00"
"103522","11","11","11","0","7","3.00"
"103536","17","17","15","2","9","3.00"
"103557","12","12","10","2","7","3.00"
"103616","9","9","7","2","3","3.00"
"103658","16","16","14","2","7","3.00"
"103680","21","20","18","3","12","3.00"
"103689","16","16","13","3","10","3.00"
"103705","12","12","12","0","7","3.00"
"103736","17","17","15","2","8","3.00"
"103746","17","17","17","0","10","3.00"
"103754","16","16","15","1","9","3.00"
"103760","10","10","9","1","7","3.00"
"103768","9","9","9","0","4","3.00"
"103775","13","13","10","3","5","3.00"
"103780","17","17","17","0","14","3.00"
"103813","7","7","5","2","3","3.00"
"103842","15","15","12","3","6","3.00"
"103845","6","6","6","0","6","3.00"
"103925","21","21","21","0","15","3.00"
"103978","12","12","11","1","9","3.00"
"103988","14","14","13","1","11","3.00"
"104017","12","12","11","1","7","3.00"
"104050","13","13","12","1","7","3.00"
"104075","11","11","10","1","8","3.00"
"104141","10","10","9","1","7","3.00"
"104159","10","10","7","3","6","3.00"
"104164","19","19","18","1","11","3.00"
"104167","14","14","13","1","9","3.00"
"104208","10","10","8","2","5","3.00"
"104210","13","13","11","2","10","3.00"
"104216","7","7","6","1","4","3.00"
"104251","9","9","8","1","7","3.00"
"104287","8","8","7","1","4","3.00"
"104317","11","11","9","2","6","3.00"
"104328","10","10","10","0","7","3.00"
"104363","20","20","19","1","15","3.00"
"104383","15","15","14","1","10","3.00"
"104386","14","14","10","4","6","3.00"
"104389","7","7","5","2","2","3.00"
"104449","10","10","10","0","6","3.00"
"104451","17","17","14","3","10","3.00"
"104483","17","17","16","1","9","3.00"
"104493","14","14","13","1","9","3.00"
"104529","12","12","9","3","4","3.00"
"104546","7","7","6","1","6","3.00"
"104550","17","17","16","1","12","3.00"
"104555","16","16","15","1","11","3.00"
"104568","6","6","6","0","4","3.00"
"104574","11","11","11","0","6","3.00"
"104591","14","14","12","2","11","3.00"
"104611","15","15","11","4","4","3.00"
"104613","15","15","15","0","11","3.00"
"104627","12","12","10","2","8","3.00"
"104658","11","11","10","1","6","3.00"
"104659","14","14","13","1","6","3.00"
"104698","17","17","15","2","11","3.00"
"104704","14","14","14","0","10","3.00"
"104705","12","12","11","1","6","3.00"
"104718","12","12","11","1","7","3.00"
"104739","14","14","12","2","8","3.00"
"104749","11","11","8","3","7","3.00"
"104785","13","13","12","1","8","3.00"
"104790","14","14","13","1","8","3.00"
"104810","11","11","10","1","6","3.00"
"104871","13","13","11","2","4","3.00"
"104876","18","18","15","3","13","3.00"
"104882","11","11","11","0","8","3.00"
"104921","15","15","14","1","7","3.00"
"104991","16","16","16","0","7","3.00"
"104996","15","15","13","2","8","3.00"
"105044","14","14","12","2","7","3.00"
"105059","19","19","16","3","12","3.00"
"105079","12","12","9","3","3","3.00"
"105084","18","18","17","1","9","3.00"
"105094","16","16","15","1","11","3.00"
"105116","14","14","14","0","7","3.00"
"105128","14","14","14","0","9","3.00"
"105150","7","7","7","0","6","3.00"
"105168","10","10","8","2","3","3.00"
"105187","13","13","11","2","6","3.00"
"105193","13","13","12","1","8","3.00"
"105203","11","11","10","1","6","3.00"
"105205","16","16","13","3","6","3.00"
"105207","12","12","9","3","5","3.00"
"105212","13","13","12","1","12","3.00"
"105221","14","14","14","0","8","3.00"
"105232","12","12","11","1","5","3.00"
"105255","13","13","10","3","7","3.00"
"105269","9","9","9","0","5","3.00"
"105279","16","16","16","0","12","3.00"
"105313","12","12","12","0","7","3.00"
"105317","9","9","8","1","6","3.00"
"105366","14","14","13","1","7","3.00"
"105370","12","12","9","3","7","3.00"
"105378","14","14","14","0","8","3.00"
"105435","27","27","23","4","17","3.00"
"105447","20","20","17","3","11","3.00"
"105500","9","9","8","1","5","3.00"
"105504","18","18","14","4","6","3.00"
"105512","15","15","14","1","7","3.00"
"105556","9","9","9","0","7","3.00"
"105558","17","17","16","1","11","3.00"
"105576","10","10","7","3","4","3.00"
"105600","8","8","8","0","5","3.00"
"105667","14","14","13","1","11","3.00"
"105670","14","14","14","0","10","3.00"
"105727","14","14","9","5","4","3.00"
"105733","6","6","5","1","4","3.00"
"105743","7","7","6","1","2","3.00"
"105830","15","15","14","1","7","3.00"
"105844","16","16","14","2","9","3.00"
"105880","18","18","14","4","12","3.00"
"105987","15","15","14","1","10","3.00"
"106008","9","9","9","0","8","3.00"
"106063","9","9","9","0","5","3.00"
"106153","14","14","13","1","7","3.00"
"106160","12","12","11","1","9","3.00"
"106178","16","15","15","1","11","3.00"
"106249","12","12","11","1","7","3.00"
"106269","14","14","14","0","7","3.00"
"106312","16","16","13","3","12","3.00"
"106330","12","12","10","2","6","3.00"
"106342","12","12","9","3","6","3.00"
"106411","10","10","8","2","4","3.00"
"106455","13","13","13","0","9","3.00"
"106491","10","10","8","2","6","3.00"
"106507","16","16","14","2","10","3.00"
"106523","14","14","13","1","7","3.00"
"106564","13","13","12","1","10","3.00"
"106572","18","18","16","2","11","3.00"
"106612","15","15","13","2","9","3.00"
"106616","15","15","13","2","9","3.00"
"106636","10","10","6","4","4","3.00"
"106659","13","13","12","1","7","3.00"
"106661","11","11","10","1","8","3.00"
"106682","12","12","12","0","7","3.00"
"106749","13","13","12","1","8","3.00"
"106802","16","16","15","1","10","3.00"
"106818","17","17","17","0","11","3.00"
"106844","10","10","9","1","4","3.00"
"106904","14","14","13","1","9","3.00"
"106931","17","17","16","1","12","3.00"
"106934","16","16","12","4","6","3.00"
"106945","8","8","8","0","5","3.00"
"106947","12","12","11","1","6","3.00"
"106951","12","12","10","2","10","3.00"
"106954","13","13","11","2","6","3.00"
"106967","7","7","6","1","5","3.00"
"106983","19","19","18","1","10","3.00"
"107000","14","14","12","2","7","3.00"
"107013","17","17","14","3","7","3.00"
"107015","14","14","10","4","5","3.00"
"107017","12","12","11","1","4","3.00"
"107028","11","10","11","0","7","3.00"
"107032","11","11","9","2","5","3.00"
"107035","13","13","12","1","5","3.00"
"107049","14","14","12","2","8","3.00"
"107075","9","9","6","3","3","3.00"
"107141","10","10","9","1","8","3.00"
"107160","12","12","11","1","7","3.00"
"107169","8","8","8","0","4","3.00"
"107182","14","14","12","2","10","3.00"
"107202","11","11","10","1","8","3.00"
"107222","5","5","5","0","3","3.00"
"107257","6","6","4","2","2","3.00"
"107265","15","15","15","0","7","3.00"
"107271","12","12","11","1","8","3.00"
"107294","9","9","8","1","7","3.00"
"107306","16","16","13","3","8","3.00"
"107310","16","16","12","4","10","3.00"
"107326","11","11","9","2","8","3.00"
"107332","12","12","9","3","6","3.00"
"107350","14","14","13","1","9","3.00"
"107370","9","9","7","2","2","3.00"
"107417","14","14","13","1","10","3.00"
"107449","12","12","12","0","8","3.00"
"107479","9","9","8","1","5","3.00"
"107526","8","8","7","1","4","3.00"
"107545","13","13","12","1","7","3.00"
"107570","17","17","15","2","10","3.00"
"107583","13","13","12","1","7","3.00"
"107605","16","16","14","2","9","3.00"
"107639","16","16","14","2","12","3.00"
"107687","9","9","9","0","4","3.00"
"107691","13","13","13","0","9","3.00"
"107696","13","13","11","2","9","3.00"
"107708","8","8","7","1","4","3.00"
"107730","12","12","10","2","9","3.00"
"107741","13","13","11","2","6","3.00"
"107816","13","13","11","2","6","3.00"
"107866","9","9","6","3","4","3.00"
"107887","10","10","9","1","7","3.00"
"107916","18","18","16","2","11","3.00"
"107918","15","15","14","1","9","3.00"
"107932","13","13","11","2","8","3.00"
"107956","13","13","12","1","9","3.00"
"107982","11","11","6","5","5","3.00"
"108015","15","15","15","0","9","3.00"
"108020","7","7","7","0","6","3.00"
"108107","12","12","10","2","7","3.00"
"108108","20","19","19","1","11","3.00"
"108113","10","10","10","0","5","3.00"
"108114","14","14","10","4","8","3.00"
"108123","17","17","17","0","15","3.00"
"108132","15","15","14","1","8","3.00"
"108182","11","11","9","2","5","3.00"
"108212","15","15","14","1","6","3.00"
"108219","13","13","12","1","11","3.00"
"108228","13","13","12","1","5","3.00"
"108237","8","8","7","1","2","3.00"
"108263","10","10","10","0","9","3.00"
"108270","7","7","7","0","5","3.00"
"108277","17","17","15","2","13","3.00"
"108362","15","15","14","1","8","3.00"
"108438","15","15","12","3","9","3.00"
"108466","11","11","9","2","7","3.00"
"108469","12","12","10","2","6","3.00"
"108487","10","10","10","0","2","3.00"
"108509","6","6","5","1","5","3.00"
"108535","9","9","9","0","6","3.00"
"108542","8","8","8","0","7","3.00"
"108553","11","11","9","2","7","3.00"
"108554","7","7","6","1","4","3.00"
"108570","19","19","19","0","13","3.00"
"108574","15","15","12","3","7","3.00"
"108597","14","14","12","2","8","3.00"
"108603","19","19","16","3","9","3.00"
"108645","14","14","14","0","9","3.00"
"108652","5","5","4","1","2","3.00"
"108673","12","12","11","1","10","3.00"
"108691","15","15","14","1","11","3.00"
"108711","17","17","15","2","11","3.00"
"108714","14","14","12","2","7","3.00"
"108719","12","12","12","0","7","3.00"
"108738","15","15","15","0","11","3.00"
"108739","11","11","8","3","6","3.00"
"108792","10","10","10","0","6","3.00"
"108816","11","11","8","3","8","3.00"
"108866","16","16","14","2","11","3.00"
"108928","14","14","12","2","10","3.00"
"108931","16","16","14","2","9","3.00"
"108944","12","12","11","1","7","3.00"
"108975","14","14","13","1","9","3.00"
"109004","18","18","15","3","10","3.00"
"109005","20","20","19","1","15","3.00"
"109030","14","14","14","0","11","3.00"
"109057","8","8","6","2","3","3.00"
"109063","10","10","9","1","7","3.00"
"109072","11","11","9","2","6","3.00"
"109084","13","13","8","5","5","3.00"
"109103","5","5","4","1","4","3.00"
"109116","9","9","9","0","5","3.00"
"109139","11","11","9","2","5","3.00"
"109171","14","14","14","0","10","3.00"
"109179","18","18","17","1","10","3.00"
"109192","14","14","12","2","10","3.00"
"109198","13","13","11","2","8","3.00"
"109228","11","11","9","2","3","3.00"
"109264","7","7","7","0","6","3.00"
"109266","20","20","19","1","17","3.00"
"109267","16","16","16","0","8","3.00"
"109286","16","16","10","6","5","3.00"
"109291","22","22","21","1","13","3.00"
"109295","7","7","5","2","4","3.00"
"109300","13","13","13","0","9","3.00"
"109302","12","12","10","2","7","3.00"
"109314","13","13","10","3","3","3.00"
"109366","6","6","5","1","3","3.00"
"109375","17","17","16","1","5","3.00"
"109378","19","19","18","1","12","3.00"
"109385","10","10","10","0","6","3.00"
"109403","10","10","8","2","6","3.00"
"109417","12","12","11","1","7","3.00"
"109422","13","13","13","0","12","3.00"
"109464","17","17","11","6","6","3.00"
"109477","10","10","10","0","7","3.00"
"109485","9","9","9","0","5","3.00"
"109512","9","9","8","1","6","3.00"
"109518","11","11","11","0","7","3.00"
"109526","8","8","8","0","3","3.00"
"109548","8","8","8","0","6","3.00"
"109553","11","11","9","2","7","3.00"
"109569","9","9","8","1","8","3.00"
"109573","10","10","10","0","5","3.00"
"109592","15","15","14","1","10","3.00"
"109640","15","15","14","1","10","3.00"
"109641","17","17","16","1","16","3.00"
"109657","16","16","13","3","10","3.00"
"109662","16","16","14","2","11","3.00"
"109749","14","14","13","1","9","3.00"
"109841","12","12","11","1","9","3.00"
"109851","11","11","10","1","8","3.00"
"109869","15","15","13","2","10","3.00"
"109926","12","12","11","1","11","3.00"
"109928","14","14","11","3","7","3.00"
"109981","16","16","14","2","11","3.00"
"110055","23","23","22","1","18","3.00"
"110071","13","13","11","2","9","3.00"
"110108","16","16","14","2","8","3.00"
"110112","15","15","14","1","10","3.00"
"110134","15","15","15","0","10","3.00"
"110149","16","16","13","3","7","3.00"
"110170","17","17","15","2","11","3.00"
"110189","8","8","8","0","6","3.00"
"110193","10","10","8","2","4","3.00"
"110280","11","11","11","0","6","3.00"
"110345","7","7","7","0","4","3.00"
"110360","9","9","8","1","4","3.00"
"110366","17","17","14","3","7","3.00"
"110376","12","12","12","0","7","3.00"
"110442","10","10","9","1","6","3.00"
"110457","22","22","19","3","12","3.00"
"110476","15","15","14","1","7","3.00"
"110483","13","13","13","0","8","3.00"
"110492","10","10","8","2","5","3.00"
"110495","14","14","11","3","9","3.00"
"110529","14","14","13","1","6","3.00"
"110549","10","10","9","1","5","3.00"
"110558","11","11","10","1","7","3.00"
"110584","12","12","11","1","7","3.00"
"110604","14","14","13","1","9","3.00"
"110622","4","4","3","1","2","3.00"
"110659","12","12","10","2","7","3.00"
"110693","19","19","17","2","11","3.00"
"110695","10","10","8","2","6","3.00"
"110698","14","14","11","3","7","3.00"
"110724","9","9","9","0","6","3.00"
"110725","20","20","17","3","9","3.00"
"110763","7","7","7","0","4","3.00"
"110798","11","11","10","1","9","3.00"
"110822","11","11","11","0","8","3.00"
"110836","14","14","12","2","6","3.00"
"110840","13","13","13","0","10","3.00"
"110856","12","12","10","2","10","3.00"
"110879","13","13","13","0","9","3.00"
"110881","19","19","14","5","12","3.00"
"110907","16","16","15","1","12","3.00"
"110953","14","14","11","3","9","3.00"
"110972","11","11","10","1","7","3.00"
"110974","15","15","14","1","8","3.00"
"111003","13","13","13","0","5","3.00"
"111005","10","10","7","3","5","3.00"
"111014","18","18","15","3","7","3.00"
"111026","14","14","12","2","9","3.00"
"111030","13","13","13","0","9","3.00"
"111052","12","12","10","2","10","3.00"
"111058","13","13","11","2","6","3.00"
"111061","14","14","13","1","11","3.00"
"111071","14","14","12","2","6","3.00"
"111084","11","11","11","0","7","3.00"
"111146","4","4","4","0","3","3.00"
"111156","9","9","8","1","5","3.00"
"111157","7","7","6","1","4","3.00"
"111181","8","8","6","2","4","3.00"
"111240","11","11","11","0","8","3.00"
"111259","21","21","18","3","12","3.00"
"111268","17","17","16","1","8","3.00"
"111293","13","13","7","6","4","3.00"
"111296","11","11","9","2","5","3.00"
"111319","13","13","11","2","6","3.00"
"111335","13","13","10","3","6","3.00"
"111357","12","12","11","1","7","3.00"
"111366","11","11","9","2","6","3.00"
"111382","11","11","11","0","6","3.00"
"111463","9","9","8","1","6","3.00"
"111516","9","9","7","2","5","3.00"
"111519","8","8","7","1","6","3.00"
"111599","22","22","20","2","14","3.00"
"111610","12","12","8","4","5","3.00"
"111629","10","10","10","0","6","3.00"
"111634","17","17","16","1","11","3.00"
"111639","14","14","14","0","8","3.00"
"111682","17","17","15","2","11","3.00"
"111696","16","16","11","5","6","3.00"
"111710","11","11","10","1","9","3.00"
"111729","12","12","9","3","2","3.00"
"111733","13","13","11","2","7","3.00"
"111779","15","15","15","0","10","3.00"
"111782","16","16","15","1","11","3.00"
"111803","18","18","12","6","7","3.00"
"111855","13","13","12","1","8","3.00"
"111884","6","6","5","1","3","3.00"
"111890","10","10","6","4","3","3.00"
"111904","14","14","13","1","10","3.00"
"111907","9","9","9","0","4","3.00"
"111916","7","7","6","1","5","3.00"
"111943","12","12","10","2","8","3.00"
"112017","7","7","7","0","6","3.00"
"112018","9","9","9","0","8","3.00"
"112080","12","12","10","2","5","3.00"
"112083","15","15","13","2","10","3.00"
"112094","11","11","9","2","6","3.00"
"112109","14","14","13","1","8","3.00"
"112122","7","7","7","0","4","3.00"
"112153","11","11","10","1","7","3.00"
"112163","30","30","27","3","16","3.00"
"112198","6","6","6","0","4","3.00"
"112199","12","12","12","0","10","3.00"
"112204","10","10","10","0","9","3.00"
"112211","11","11","10","1","4","3.00"
"112216","14","14","9","5","5","3.00"
"112227","9","9","7","2","4","3.00"
"112243","12","12","11","1","5","3.00"
"112251","7","7","7","0","4","3.00"
"112264","13","13","12","1","4","3.00"
"112278","12","12","11","1","6","3.00"
"112285","15","15","13","2","10","3.00"
"112362","12","12","11","1","7","3.00"
"112407","10","10","8","2","2","3.00"
"112425","14","14","13","1","7","3.00"
"112449","16","16","16","0","9","3.00"
"112460","13","13","12","1","8","3.00"
"112532","14","14","13","1","11","3.00"
"112547","11","11","9","2","7","3.00"
"112573","9","9","9","0","5","3.00"
"112584","14","14","14","0","9","3.00"
"112601","12","12","11","1","5","3.00"
"112617","11","11","10","1","6","3.00"
"112712","6","6","6","0","4","3.00"
"112752","12","12","11","1","7","3.00"
"112803","9","9","9","0","5","3.00"
"112827","15","15","14","1","10","3.00"
"112842","14","14","12","2","8","3.00"
"112843","19","19","19","0","12","3.00"
"112861","10","10","10","0","5","3.00"
"112867","6","6","6","0","4","3.00"
"112874","9","9","9","0","5","3.00"
"112953","7","7","5","2","4","3.00"
"112960","21","21","21","0","14","3.00"
"113003","14","14","13","1","7","3.00"
"113025","16","16","13","3","11","3.00"
"113054","11","11","10","1","4","3.00"
"113093","11","11","11","0","5","3.00"
"113107","16","16","15","1","9","3.00"
"113138","13","13","12","1","7","3.00"
"113150","12","12","9","3","5","3.00"
"113231","8","8","8","0","6","3.00"
"113238","16","16","15","1","9","3.00"
"113262","14","14","14","0","9","3.00"
"113281","15","15","12","3","7","3.00"
"113307","12","12","11","1","8","3.00"
"113314","12","12","9","3","4","3.00"
"113330","15","15","13","2","7","3.00"
"113368","17","17","15","2","9","3.00"
"113412","15","15","13","2","6","3.00"
"113429","12","12","11","1","5","3.00"
"113436","10","10","8","2","4","3.00"
"113442","16","16","16","0","12","3.00"
"113455","14","14","14","0","9","3.00"
"113493","10","9","10","0","7","3.00"
"113501","19","19","16","3","10","3.00"
"113509","10","10","10","0","7","3.00"
"113520","18","18","15","3","10","3.00"
"113586","21","21","21","0","18","3.00"
"113631","12","12","11","1","7","3.00"
"113641","8","8","7","1","4","3.00"
"113662","13","13","12","1","6","3.00"
"113694","11","11","11","0","9","3.00"
"113703","11","11","9","2","7","3.00"
"113711","9","9","8","1","4","3.00"
"113716","11","11","9","2","7","3.00"
"113718","9","9","9","0","6","3.00"
"113730","14","14","13","1","4","3.00"
"113760","9","9","8","1","6","3.00"
"113832","12","12","9","3","7","3.00"
"113865","17","17","14","3","6","3.00"
"113875","8","8","5","3","2","3.00"
"113886","8","8","6","2","3","3.00"
"113904","18","18","17","1","13","3.00"
"113912","20","20","18","2","13","3.00"
"113914","15","15","14","1","10","3.00"
"113926","14","14","13","1","8","3.00"
"113970","11","11","9","2","6","3.00"
"113979","13","13","13","0","10","3.00"
"113997","9","9","7","2","6","3.00"
"114000","13","13","12","1","9","3.00"
"114006","10","10","8","2","6","3.00"
"114067","15","15","12","3","9","3.00"
"114076","10","10","8","2","5","3.00"
"114089","14","14","11","3","7","3.00"
"114091","14","14","11","3","7","3.00"
"114121","11","11","10","1","6","3.00"
"114124","15","15","15","0","9","3.00"
"114170","20","20","17","3","13","3.00"
"114202","17","17","17","0","10","3.00"
"114208","20","20","17","3","10","3.00"
"114239","15","15","14","1","12","3.00"
"114271","9","9","9","0","6","3.00"
"114285","11","11","8","3","4","3.00"
"114329","13","13","12","1","11","3.00"
"114345","17","17","17","0","12","3.00"
"114351","15","15","14","1","8","3.00"
"114365","10","10","9","1","7","3.00"
"114373","13","13","13","0","9","3.00"
"114377","18","18","16","2","10","3.00"
"114389","10","10","10","0","4","3.00"
"114400","16","16","15","1","11","3.00"
"114417","12","12","11","1","10","3.00"
"114444","10","10","9","1","7","3.00"
"114477","19","19","19","0","15","3.00"
"114491","11","11","11","0","8","3.00"
"114507","10","10","10","0","7","3.00"
"114515","16","16","16","0","11","3.00"
"114523","14","14","11","3","8","3.00"
"114577","18","18","16","2","12","3.00"
"114668","17","17","16","1","11","3.00"
"114683","6","6","5","1","2","3.00"
"114684","12","12","11","1","6","3.00"
"114711","13","13","12","1","9","3.00"
"114733","22","22","17","5","9","3.00"
"114737","7","7","7","0","5","3.00"
"114762","11","11","9","2","6","3.00"
"114765","11","11","8","3","8","3.00"
"114784","14","14","13","1","7","3.00"
"114801","10","10","10","0","8","3.00"
"114812","16","16","16","0","9","3.00"
"114816","7","7","7","0","6","3.00"
"114836","10","10","8","2","5","3.00"
"114850","12","12","11","1","11","3.00"
"114858","16","16","16","0","11","3.00"
"114906","11","11","10","1","8","3.00"
"114958","17","17","14","3","10","3.00"
"114981","15","15","14","1","10","3.00"
"115035","14","14","11","3","7","3.00"
"115039","10","10","9","1","7","3.00"
"115058","13","13","11","2","7","3.00"
"115076","16","16","13","3","7","3.00"
"115088","15","15","13","2","8","3.00"
"115091","18","18","15","3","10","3.00"
"115097","15","15","14","1","9","3.00"
"115121","15","15","14","1","8","3.00"
"115167","15","15","13","2","12","3.00"
"115172","12","12","10","2","7","3.00"
"115223","12","12","11","1","6","3.00"
"115252","11","11","10","1","7","3.00"
"115285","7","7","4","3","4","3.00"
"115293","16","16","12","4","5","3.00"
"115302","11","11","10","1","9","3.00"
"115303","14","14","11","3","9","3.00"
"115306","9","9","8","1","4","3.00"
"115310","15","15","13","2","11","3.00"
"115333","10","10","9","1","2","3.00"
"115397","8","8","8","0","3","3.00"
"115434","7","7","7","0","4","3.00"
"115442","18","18","17","1","13","3.00"
"115477","23","23","20","3","12","3.00"
"115506","15","15","14","1","11","3.00"
"115509","14","14","14","0","8","3.00"
"115524","7","7","5","2","4","3.00"
"115565","7","7","7","0","3","3.00"
"115589","13","13","13","0","9","3.00"
"115621","9","9","9","0","6","3.00"
"115623","18","18","15","3","9","3.00"
"115632","8","8","8","0","4","3.00"
"115653","8","8","6","2","4","3.00"
"115667","9","9","8","1","5","3.00"
"115686","15","15","11","4","5","3.00"
"115694","9","9","7","2","4","3.00"
"115710","9","9","8","1","5","3.00"
"115749","13","13","13","0","8","3.00"
"115759","15","15","15","0","7","3.00"
"115771","7","7","6","1","3","3.00"
"115798","13","13","12","1","6","3.00"
"115810","18","18","17","1","8","3.00"
"115853","9","9","9","0","5","3.00"
"115863","11","11","10","1","8","3.00"
"115864","9","9","9","0","5","3.00"
"115951","12","12","11","1","10","3.00"
"115961","8","8","7","1","5","3.00"
"115978","17","17","15","2","11","3.00"
"115983","13","13","13","0","8","3.00"
"115990","13","13","10","3","7","3.00"
"115996","16","16","14","2","12","3.00"
"116096","11","11","11","0","7","3.00"
"116117","7","7","6","1","5","3.00"
"116213","11","11","9","2","4","3.00"
"116227","11","11","11","0","6","3.00"
"116254","10","10","10","0","5","3.00"
"116276","10","10","9","1","6","3.00"
"116278","22","22","15","7","8","3.00"
"116325","16","16","14","2","11","3.00"
"116341","11","11","9","2","7","3.00"
"116356","20","20","19","1","10","3.00"
"116360","8","8","7","1","4","3.00"
"116399","8","8","8","0","6","3.00"
"116464","15","15","13","2","10","3.00"
"116499","18","18","16","2","9","3.00"
"116505","14","14","13","1","7","3.00"
"116514","10","10","9","1","6","3.00"
"116542","17","17","16","1","13","3.00"
"116566","13","13","13","0","8","3.00"
"116583","11","11","10","1","7","3.00"
"116603","10","10","10","0","5","3.00"
"116613","11","11","9","2","5","3.00"
"116698","13","13","12","1","9","3.00"
"116701","14","14","12","2","4","3.00"
"116735","15","15","12","3","6","3.00"
"116758","15","15","14","1","8","3.00"
"116811","7","7","6","1","3","3.00"
"116852","7","7","7","0","7","3.00"
"116854","15","15","14","1","10","3.00"
"116870","11","11","8","3","3","3.00"
"116873","18","18","15","3","10","3.00"
"116923","10","10","10","0","6","3.00"
"116925","11","11","10","1","8","3.00"
"116944","17","17","14","3","11","3.00"
"116962","16","16","15","1","14","3.00"
"116978","24","24","22","2","17","3.00"
"116988","12","12","10","2","7","3.00"
"116999","12","12","10","2","7","3.00"
"117012","8","8","7","1","5","3.00"
"117024","10","10","10","0","6","3.00"
"117065","8","8","5","3","3","3.00"
"117068","11","11","9","2","5","3.00"
"117077","13","13","13","0","8","3.00"
"117081","15","15","14","1","7","3.00"
"117089","12","12","12","0","7","3.00"
"117094","13","13","12","1","7","3.00"
"117101","18","18","17","1","10","3.00"
"117102","14","14","11","3","8","3.00"
"117200","12","12","11","1","6","3.00"
"117237","14","14","12","2","7","3.00"
"117239","12","12","10","2","3","3.00"
"117247","17","17","16","1","12","3.00"
"117253","14","14","12","2","7","3.00"
"117265","8","8","6","2","4","3.00"
"117368","16","16","15","1","13","3.00"
"117394","10","10","10","0","9","3.00"
"117400","13","13","12","1","7","3.00"
"117422","12","12","11","1","8","3.00"
"117436","12","12","11","1","6","3.00"
"117447","14","14","11","3","10","3.00"
"117452","17","17","15","2","10","3.00"
"117492","18","18","15","3","11","3.00"
"117514","13","13","12","1","9","3.00"
"117527","18","18","13","5","9","3.00"
"117558","17","16","16","1","13","3.00"
"117576","15","15","15","0","12","3.00"
"104469","22","22","21","1","13","2.99"
"108424","20","20","18","2","13","2.99"
"114771","18","18","17","1","13","2.99"
"100334","17","17","17","0","12","2.98"
"101104","19","19","16","3","11","2.98"
"101690","17","17","14","3","10","2.98"
"102820","19","19","18","1","13","2.98"
"102997","20","20","18","2","11","2.98"
"103682","19","19","18","1","15","2.98"
"105560","17","17","15","2","10","2.98"
"106011","19","19","17","2","9","2.98"
"106038","17","17","17","0","13","2.98"
"106350","18","18","15","3","12","2.98"
"106531","20","20","19","1","13","2.98"
"107259","16","16","15","1","14","2.98"
"107342","17","17","17","0","11","2.98"
"107616","19","19","17","2","14","2.98"
"108030","18","18","17","1","12","2.98"
"108159","13","13","12","1","11","2.98"
"108205","18","18","17","1","12","2.98"
"110199","22","22","21","1","15","2.98"
"110265","21","21","21","0","16","2.98"
"110511","19","19","17","2","13","2.98"
"111574","16","16","12","4","12","2.98"
"111709","23","23","19","4","13","2.98"
"112030","18","18","17","1","13","2.98"
"112146","21","21","18","3","11","2.98"
"112639","21","21","21","0","15","2.98"
"113240","18","18","17","1","12","2.98"
"113338","13","13","12","1","10","2.98"
"113522","14","14","13","1","10","2.98"
"113885","18","18","18","0","14","2.98"
"113971","21","21","17","4","13","2.98"
"114052","16","16","16","0","14","2.98"
"114253","20","20","20","0","15","2.98"
"114734","14","14","11","3","11","2.98"
"114819","21","21","18","3","13","2.98"
"115027","19","19","18","1","12","2.98"
"115500","17","17","17","0","13","2.98"
"115507","22","22","20","2","17","2.98"
"116141","12","12","11","1","10","2.98"
"116251","22","22","22","0","15","2.98"
"116392","22","22","18","4","14","2.98"
"116696","16","16","15","1","11","2.98"
"116918","15","15","14","1","12","2.98"
"101202","14","14","14","0","9","2.97"
"101606","14","14","12","2","8","2.97"
"101734","16","16","15","1","10","2.97"
"102027","16","16","14","2","11","2.97"
"102766","12","12","11","1","9","2.97"
"102842","10","10","10","0","8","2.97"
"102919","16","16","16","0","13","2.97"
"104499","17","17","16","1","12","2.97"
"105244","15","15","12","3","9","2.97"
"105543","18","18","15","3","9","2.97"
"105595","18","18","16","2","12","2.97"
"105634","13","13","11","2","9","2.97"
"105676","19","19","15","4","13","2.97"
"105699","15","15","14","1","10","2.97"
"105705","14","14","12","2","8","2.97"
"106505","18","18","16","2","11","2.97"
"106615","11","11","11","0","8","2.97"
"106757","14","14","12","2","12","2.97"
"107610","14","14","13","1","8","2.97"
"107886","15","15","14","1","9","2.97"
"108133","20","20","18","2","16","2.97"
"108630","14","14","14","0","9","2.97"
"108720","14","14","14","0","13","2.97"
"108821","12","12","11","1","8","2.97"
"108870","15","15","15","0","12","2.97"
"108873","28","27","25","3","19","2.97"
"108884","20","20","19","1","13","2.97"
"109357","18","18","16","2","12","2.97"
"109441","11","11","11","0","9","2.97"
"109528","17","17","17","0","13","2.97"
"109942","14","14","13","1","11","2.97"
"109946","16","16","16","0","14","2.97"
"109948","13","13","12","1","8","2.97"
"109986","22","22","20","2","14","2.97"
"110412","18","18","17","1","11","2.97"
"110742","13","13","11","2","8","2.97"
"110903","11","11","11","0","8","2.97"
"111327","20","20","16","4","14","2.97"
"111685","16","16","15","1","12","2.97"
"111920","18","18","17","1","11","2.97"
"112116","20","20","16","4","14","2.97"
"112393","16","16","15","1","13","2.97"
"112821","20","20","20","0","19","2.97"
"112860","16","16","13","3","8","2.97"
"113701","21","21","16","5","9","2.97"
"114063","14","14","12","2","11","2.97"
"114336","18","18","13","5","10","2.97"
"115178","21","21","19","2","11","2.97"
"115222","16","16","15","1","9","2.97"
"115422","15","15","13","2","10","2.97"
"115606","19","19","17","2","12","2.97"
"117010","12","12","11","1","8","2.97"
"117049","13","13","13","0","10","2.97"
"117278","11","11","11","0","8","2.97"
"117449","18","18","16","2","11","2.97"
"100250","14","14","13","1","9","2.96"
"100409","14","14","14","0","11","2.96"
"100803","17","16","15","2","13","2.96"
"101328","17","17","16","1","14","2.96"
"101460","12","12","12","0","10","2.96"
"101812","16","16","15","1","13","2.96"
"102083","13","13","11","2","10","2.96"
"102155","19","19","17","2","12","2.96"
"102340","22","22","18","4","15","2.96"
"102365","23","23","22","1","17","2.96"
"102477","24","24","23","1","17","2.96"
"103084","21","21","20","1","15","2.96"
"103617","12","12","12","0","11","2.96"
"104140","14","14","14","0","10","2.96"
"104232","12","12","11","1","10","2.96"
"104691","23","23","20","3","12","2.96"
"104917","18","18","17","1","11","2.96"
"105090","9","9","9","0","7","2.96"
"105338","16","16","14","2","12","2.96"
"105651","20","20","19","1","11","2.96"
"105843","20","20","17","3","16","2.96"
"105878","15","15","15","0","12","2.96"
"106070","15","15","14","1","11","2.96"
"106897","16","16","15","1","9","2.96"
"107320","18","18","17","1","12","2.96"
"107828","13","13","12","1","8","2.96"
"108192","21","21","20","1","15","2.96"
"108216","17","17","15","2","13","2.96"
"108225","12","12","11","1","7","2.96"
"108267","15","15","13","2","12","2.96"
"108296","17","17","15","2","12","2.96"
"108638","18","18","17","1","13","2.96"
"108776","19","19","19","0","13","2.96"
"109012","11","11","11","0","7","2.96"
"109133","10","10","9","1","9","2.96"
"109274","16","16","15","1","9","2.96"
"109704","20","20","18","2","16","2.96"
"110077","19","19","17","2","9","2.96"
"110151","16","16","12","4","8","2.96"
"110216","15","15","14","1","11","2.96"
"110468","23","23","20","3","18","2.96"
"110970","10","10","10","0","9","2.96"
"111235","19","19","16","3","13","2.96"
"112441","15","15","13","2","8","2.96"
"112528","11","11","9","2","7","2.96"
"113083","14","14","12","2","9","2.96"
"113301","23","23","20","3","14","2.96"
"113459","18","18","16","2","12","2.96"
"113663","17","17","15","2","11","2.96"
"113772","14","14","13","1","10","2.96"
"114829","14","14","13","1","7","2.96"
"114903","15","15","13","2","10","2.96"
"114971","24","24","21","3","12","2.96"
"115430","17","17","13","4","10","2.96"
"116425","17","17","14","3","9","2.96"
"117288","10","10","10","0","9","2.96"
"100358","14","14","14","0","8","2.95"
"100522","16","16","14","2","9","2.95"
"100775","21","21","17","4","14","2.95"
"100787","17","17","17","0","13","2.95"
"100861","13","13","12","1","8","2.95"
"100994","14","14","11","3","8","2.95"
"101138","13","13","10","3","9","2.95"
"101232","17","17","16","1","10","2.95"
"101341","16","16","13","3","9","2.95"
"101506","20","20","17","3","11","2.95"
"101570","16","16","14","2","9","2.95"
"101714","14","14","12","2","10","2.95"
"101900","11","11","10","1","9","2.95"
"102442","16","16","15","1","12","2.95"
"102560","15","15","14","1","10","2.95"
"102770","20","20","20","0","14","2.95"
"102834","20","20","19","1","11","2.95"
"102929","18","18","18","0","13","2.95"
"103014","10","10","8","2","8","2.95"
"103038","15","15","14","1","11","2.95"
"103102","13","13","12","1","10","2.95"
"103313","17","17","14","3","9","2.95"
"103320","11","11","9","2","8","2.95"
"104273","15","15","14","1","12","2.95"
"104589","13","13","12","1","10","2.95"
"104599","13","13","12","1","8","2.95"
"104616","14","14","13","1","9","2.95"
"104626","21","21","18","3","11","2.95"
"105183","14","14","13","1","8","2.95"
"105448","20","20","19","1","9","2.95"
"105463","15","15","15","0","12","2.95"
"105551","13","13","12","1","8","2.95"
"105606","15","15","13","2","10","2.95"
"105737","16","16","16","0","10","2.95"
"106136","15","14","15","0","11","2.95"
"106324","14","14","13","1","10","2.95"
"106441","17","17","16","1","9","2.95"
"106673","12","12","10","2","9","2.95"
"107132","18","18","17","1","11","2.95"
"107581","12","12","11","1","10","2.95"
"107774","22","22","21","1","13","2.95"
"107891","18","18","15","3","12","2.95"
"108187","13","13","12","1","9","2.95"
"108281","18","18","18","0","11","2.95"
"108657","14","14","14","0","11","2.95"
"108848","19","19","18","1","10","2.95"
"108934","12","12","12","0","9","2.95"
"109006","13","13","13","0","8","2.95"
"109260","15","15","11","4","8","2.95"
"109372","17","17","15","2","10","2.95"
"109629","17","17","16","1","11","2.95"
"109721","17","17","16","1","10","2.95"
"109872","23","23","23","0","21","2.95"
"109964","11","11","10","1","9","2.95"
"110195","18","18","15","3","10","2.95"
"110223","11","11","10","1","9","2.95"
"110414","16","16","15","1","11","2.95"
"110459","16","16","14","2","11","2.95"
"110469","13","13","11","2","10","2.95"
"110735","16","16","15","1","10","2.95"
"110990","17","17","15","2","10","2.95"
"111141","13","13","13","0","10","2.95"
"111617","15","15","14","1","11","2.95"
"111851","19","19","16","3","12","2.95"
"112038","12","12","12","0","9","2.95"
"112472","15","15","13","2","8","2.95"
"112985","16","16","14","2","10","2.95"
"113017","13","13","12","1","8","2.95"
"113762","20","20","19","1","14","2.95"
"113973","14","14","12","2","9","2.95"
"114414","16","16","16","0","15","2.95"
"114575","18","18","17","1","11","2.95"
"114787","17","17","17","0","16","2.95"
"114803","15","15","13","2","11","2.95"
"115107","15","15","14","1","11","2.95"
"115245","13","13","11","2","8","2.95"
"115494","19","19","16","3","12","2.95"
"115920","20","20","19","1","12","2.95"
"116322","18","18","17","1","12","2.95"
"116485","21","21","20","1","9","2.95"
"116490","15","15","14","1","13","2.95"
"116734","18","18","16","2","13","2.95"
"116827","23","23","20","3","13","2.95"
"116984","18","18","16","2","9","2.95"
"117117","13","13","12","1","9","2.95"
"117162","13","13","12","1","9","2.95"
"117476","18","18","17","1","16","2.95"
"117499","17","17","17","0","12","2.95"
"100082","20","20","19","1","13","2.94"
"100232","18","18","16","2","14","2.94"
"100390","17","17","16","1","9","2.94"
"100727","15","15","14","1","12","2.94"
"100756","19","19","16","3","10","2.94"
"100884","12","12","12","0","7","2.94"
"100902","20","20","16","4","11","2.94"
"101382","22","22","19","3","12","2.94"
"101397","17","17","17","0","13","2.94"
"102428","19","19","17","2","13","2.94"
"102441","20","20","19","1","15","2.94"
"102614","14","14","14","0","11","2.94"
"102854","17","17","16","1","12","2.94"
"102912","14","14","13","1","11","2.94"
"103145","7","7","7","0","6","2.94"
"103256","24","24","23","1","18","2.94"
"103430","19","19","17","2","10","2.94"
"103474","20","20","18","2","15","2.94"
"103858","16","16","15","1","11","2.94"
"104044","14","14","13","1","11","2.94"
"104178","18","18","16","2","12","2.94"
"105033","12","12","11","1","10","2.94"
"105256","16","16","16","0","11","2.94"
"105315","14","14","12","2","10","2.94"
"105521","17","17","15","2","12","2.94"
"105722","15","15","15","0","9","2.94"
"106475","17","17","16","1","12","2.94"
"106644","19","19","17","2","13","2.94"
"106960","16","16","16","0","12","2.94"
"107022","19","19","18","1","13","2.94"
"107301","18","18","17","1","13","2.94"
"107564","18","18","18","0","14","2.94"
"107608","16","16","15","1","8","2.94"
"107661","18","18","14","4","12","2.94"
"107946","16","16","14","2","11","2.94"
"108262","21","21","19","2","12","2.94"
"108725","13","13","9","4","6","2.94"
"108955","16","16","15","1","14","2.94"
"108996","19","19","16","3","10","2.94"
"109298","15","15","15","0","11","2.94"
"109315","14","14","14","0","11","2.94"
"109393","18","17","17","1","9","2.94"
"109462","14","14","14","0","11","2.94"
"109767","13","13","10","3","8","2.94"
"109837","12","12","12","0","9","2.94"
"110467","12","12","12","0","11","2.94"
"110639","23","23","20","3","14","2.94"
"110722","16","16","15","1","13","2.94"
"110898","14","14","13","1","11","2.94"
"111137","15","15","15","0","10","2.94"
"111317","19","19","16","3","10","2.94"
"111647","13","13","12","1","10","2.94"
"111702","13","13","13","0","7","2.94"
"111886","22","22","18","4","13","2.94"
"112044","13","13","12","1","11","2.94"
"112341","14","14","11","3","9","2.94"
"112551","17","17","17","0","10","2.94"
"112627","17","17","17","0","11","2.94"
"112717","22","22","18","4","12","2.94"
"112990","12","12","11","1","7","2.94"
"113068","17","17","16","1","12","2.94"
"113088","16","16","14","2","12","2.94"
"113242","17","17","16","1","13","2.94"
"113610","19","19","17","2","13","2.94"
"113751","13","13","13","0","9","2.94"
"113758","17","17","16","1","14","2.94"
"113964","15","15","12","3","11","2.94"
"114215","17","17","16","1","12","2.94"
"114376","14","14","14","0","10","2.94"
"114516","16","16","15","1","11","2.94"
"114724","16","16","14","2","11","2.94"
"114832","22","22","19","3","14","2.94"
"114904","24","24","18","6","14","2.94"
"114995","21","21","19","2","12","2.94"
"115173","18","18","16","2","11","2.94"
"115284","7","7","6","1","6","2.94"
"115411","19","19","17","2","11","2.94"
"115511","11","11","11","0","9","2.94"
"115635","14","14","14","0","10","2.94"
"115661","15","15","14","1","12","2.94"
"115925","15","15","13","2","10","2.94"
"116044","7","7","7","0","6","2.94"
"116384","19","19","15","4","11","2.94"
"117045","18","18","17","1","12","2.94"
"117250","13","13","13","0","9","2.94"
"117361","17","17","16","1","12","2.94"
"117578","11","11","10","1","6","2.94"
"100264","17","17","13","4","9","2.93"
"100359","17","17","15","2","10","2.93"
"100371","15","15","13","2","10","2.93"
"100819","18","18","15","3","8","2.93"
"100990","17","17","15","2","9","2.93"
"101553","18","18","16","2","11","2.93"
"101579","15","15","12","3","8","2.93"
"101609","17","17","16","1","11","2.93"
"101722","13","13","12","1","8","2.93"
"101727","19","19","16","3","11","2.93"
"101840","12","12","11","1","8","2.93"
"102498","13","13","13","0","8","2.93"
"102508","17","17","15","2","9","2.93"
"102510","8","8","8","0","7","2.93"
"102542","13","13","11","2","8","2.93"
"102558","18","18","16","2","9","2.93"
"102578","24","24","21","3","17","2.93"
"102640","14","14","12","2","10","2.93"
"102709","11","11","10","1","9","2.93"
"102917","13","13","13","0","9","2.93"
"103025","11","11","10","1","9","2.93"
"103032","10","10","10","0","7","2.93"
"103039","15","15","15","0","12","2.93"
"103155","16","16","14","2","9","2.93"
"103274","17","17","15","2","9","2.93"
"103411","18","18","16","2","13","2.93"
"103484","13","13","11","2","9","2.93"
"103755","16","16","16","0","10","2.93"
"103803","14","13","11","3","8","2.93"
"103843","21","21","18","3","11","2.93"
"104051","11","11","11","0","9","2.93"
"104148","17","17","15","2","10","2.93"
"104298","15","15","15","0","12","2.93"
"104424","10","10","8","2","8","2.93"
"104662","17","17","16","1","14","2.93"
"104981","9","9","9","0","7","2.93"
"105099","15","15","14","1","10","2.93"
"105130","15","15","13","2","10","2.93"
"105408","19","19","15","4","8","2.93"
"105638","15","15","13","2","12","2.93"
"105730","18","18","17","1","7","2.93"
"105762","15","15","12","3","10","2.93"
"105800","12","12","9","3","8","2.93"
"105833","15","15","13","2","8","2.93"
"105863","12","12","11","1","7","2.93"
"106193","14","14","13","1","8","2.93"
"106286","12","12","11","1","10","2.93"
"106313","18","18","18","0","12","2.93"
"106394","17","17","13","4","10","2.93"
"106638","13","13","11","2","8","2.93"
"106703","16","16","14","2","10","2.93"
"106725","17","17","12","5","10","2.93"
"106948","18","18","12","6","10","2.93"
"107781","16","16","16","0","10","2.93"
"107825","15","15","14","1","12","2.93"
"108324","16","16","15","1","12","2.93"
"108360","11","11","10","1","7","2.93"
"108445","18","18","16","2","15","2.93"
"108480","24","24","20","4","13","2.93"
"108481","16","16","16","0","13","2.93"
"108589","14","14","13","1","9","2.93"
"108647","22","22","21","1","18","2.93"
"108667","13","13","11","2","10","2.93"
"108883","25","25","21","4","13","2.93"
"108908","16","16","15","1","11","2.93"
"108937","22","22","20","2","11","2.93"
"109067","14","14","14","0","11","2.93"
"109117","18","18","16","2","13","2.93"
"109392","15","15","12","3","9","2.93"
"109404","17","17","15","2","10","2.93"
"109482","12","12","10","2","9","2.93"
"109509","15","15","15","0","8","2.93"
"109525","15","15","13","2","9","2.93"
"109529","14","13","13","1","8","2.93"
"109551","15","15","14","1","14","2.93"
"109563","13","13","11","2","10","2.93"
"109976","12","12","11","1","9","2.93"
"110227","14","14","13","1","8","2.93"
"110234","12","12","10","2","7","2.93"
"110275","16","16","14","2","11","2.93"
"110482","13","13","12","1","9","2.93"
"110539","13","13","13","0","11","2.93"
"110935","14","14","13","1","9","2.93"
"110980","19","19","18","1","11","2.93"
"111101","18","18","17","1","15","2.93"
"111178","20","20","20","0","14","2.93"
"111251","15","15","14","1","9","2.93"
"111368","11","11","10","1","8","2.93"
"111466","16","16","13","3","11","2.93"
"111532","14","14","12","2","10","2.93"
"111556","10","10","9","1","7","2.93"
"111689","15","15","13","2","9","2.93"
"111724","16","16","16","0","13","2.93"
"111747","25","24","21","4","10","2.93"
"111833","22","22","19","3","14","2.93"
"111860","14","14","13","1","8","2.93"
"111977","15","15","15","0","12","2.93"
"112104","17","17","16","1","12","2.93"
"112110","18","18","17","1","9","2.93"
"112208","16","16","16","0","11","2.93"
"112395","16","16","14","2","9","2.93"
"112481","16","16","16","0","10","2.93"
"112538","13","13","10","3","8","2.93"
"112552","10","10","9","1","8","2.93"
"112709","15","15","15","0","12","2.93"
"112903","21","21","21","0","13","2.93"
"112928","12","12","11","1","8","2.93"
"113033","22","22","20","2","16","2.93"
"113115","15","15","13","2","9","2.93"
"113167","14","14","11","3","8","2.93"
"113187","12","12","11","1","8","2.93"
"113402","16","16","15","1","9","2.93"
"113538","17","17","13","4","12","2.93"
"113868","16","16","14","2","10","2.93"
"113880","18","18","14","4","9","2.93"
"113936","15","15","12","3","7","2.93"
"114033","15","15","13","2","9","2.93"
"114043","16","16","16","0","11","2.93"
"114055","18","18","17","1","13","2.93"
"114257","15","15","13","2","9","2.93"
"114814","17","17","14","3","9","2.93"
"114899","13","13","11","2","8","2.93"
"115125","15","15","15","0","11","2.93"
"115154","13","13","13","0","10","2.93"
"115542","10","10","9","1","9","2.93"
"115601","10","10","10","0","9","2.93"
"115735","16","16","15","1","9","2.93"
"115898","12","12","11","1","10","2.93"
"115982","14","14","11","3","8","2.93"
"116187","15","15","13","2","8","2.93"
"116378","14","14","14","0","12","2.93"
"116515","15","15","14","1","11","2.93"
"117111","15","15","14","1","8","2.93"
"117116","13","13","12","1","8","2.93"
"117182","16","16","16","0","8","2.93"
"117194","16","16","15","1","7","2.93"
"117480","13","13","12","1","10","2.93"
"117549","16","16","16","0","10","2.93"
"100097","14","14","13","1","12","2.92"
"100273","16","16","12","4","9","2.92"
"100364","14","14","13","1","9","2.92"
"100653","15","15","14","1","7","2.92"
"100673","15","15","15","0","10","2.92"
"100716","11","11","11","0","7","2.92"
"100840","11","11","10","1","7","2.92"
"100841","11","11","10","1","8","2.92"
"101108","15","15","15","0","10","2.92"
"101126","16","16","15","1","9","2.92"
"101335","14","14","13","1","7","2.92"
"101455","16","16","16","0","13","2.92"
"101457","17","17","13","4","9","2.92"
"101477","20","20","19","1","12","2.92"
"101572","15","15","13","2","8","2.92"
"101665","12","12","10","2","6","2.92"
"101684","15","15","13","2","10","2.92"
"101814","18","18","14","4","9","2.92"
"102123","10","10","9","1","7","2.92"
"102213","12","12","11","1","9","2.92"
"102221","16","16","15","1","7","2.92"
"102298","13","13","13","0","9","2.92"
"102385","15","15","15","0","8","2.92"
"102481","12","12","12","0","7","2.92"
"102892","14","14","13","1","8","2.92"
"102996","11","11","9","2","6","2.92"
"103000","18","18","15","3","10","2.92"
"103193","19","19","17","2","11","2.92"
"103210","20","20","18","2","16","2.92"
"103345","18","18","16","2","9","2.92"
"103370","14","14","14","0","11","2.92"
"103449","15","15","13","2","7","2.92"
"103516","16","16","15","1","10","2.92"
"103544","12","12","10","2","7","2.92"
"103781","18","18","16","2","13","2.92"
"103986","12","12","9","3","7","2.92"
"104040","24","24","21","3","17","2.92"
"104109","13","13","11","2","8","2.92"
"104113","9","9","8","1","7","2.92"
"104172","15","15","14","1","10","2.92"
"104189","12","12","11","1","8","2.92"
"104246","11","11","10","1","7","2.92"
"104300","19","19","18","1","12","2.92"
"104308","12","12","9","3","7","2.92"
"104407","16","16","14","2","8","2.92"
"104409","12","12","11","1","9","2.92"
"104443","15","15","14","1","9","2.92"
"104651","13","13","13","0","7","2.92"
"104678","16","16","15","1","11","2.92"
"104715","13","13","10","3","8","2.92"
"104893","16","16","16","0","13","2.92"
"104940","19","19","17","2","11","2.92"
"105041","14","14","12","2","10","2.92"
"105107","13","13","11","2","7","2.92"
"105131","10","10","8","2","8","2.92"
"105224","14","14","9","5","8","2.92"
"105319","8","8","8","0","6","2.92"
"105503","13","13","11","2","7","2.92"
"105513","22","22","19","3","16","2.92"
"105540","15","15","14","1","12","2.92"
"105596","11","11","9","2","8","2.92"
"105671","19","19","16","3","12","2.92"
"105802","15","15","13","2","10","2.92"
"105958","14","14","11","3","8","2.92"
"105978","15","15","14","1","9","2.92"
"106058","15","15","13","2","11","2.92"
"106103","16","16","14","2","10","2.92"
"106335","12","12","10","2","9","2.92"
"106353","17","17","16","1","14","2.92"
"106408","14","14","11","3","9","2.92"
"106451","20","20","20","0","15","2.92"
"106536","10","10","10","0","8","2.92"
"106684","16","16","14","2","10","2.92"
"106879","21","21","21","0","15","2.92"
"106893","12","12","12","0","10","2.92"
"106937","15","15","13","2","6","2.92"
"107102","13","13","12","1","7","2.92"
"107156","9","9","8","1","7","2.92"
"107239","12","12","11","1","9","2.92"
"107241","13","13","12","1","8","2.92"
"107249","17","17","15","2","9","2.92"
"107337","11","11","11","0","10","2.92"
"107378","17","17","13","4","10","2.92"
"107397","13","13","10","3","7","2.92"
"107445","17","17","16","1","11","2.92"
"107505","11","11","9","2","7","2.92"
"107653","13","13","12","1","8","2.92"
"107779","19","19","18","1","13","2.92"
"107786","16","16","14","2","11","2.92"
"107817","15","15","13","2","8","2.92"
"108052","12","12","11","1","9","2.92"
"108167","19","19","17","2","13","2.92"
"108251","13","13","12","1","7","2.92"
"108539","21","21","18","3","14","2.92"
"108752","16","16","15","1","9","2.92"
"108790","11","11","9","2","6","2.92"
"109210","17","17","16","1","10","2.92"
"109214","20","20","15","5","10","2.92"
"109665","18","18","15","3","10","2.92"
"109766","14","14","13","1","9","2.92"
"110017","14","14","12","2","9","2.92"
"110794","20","20","16","4","10","2.92"
"110920","16","16","14","2","10","2.92"
"111039","14","14","12","2","9","2.92"
"111082","12","12","11","1","7","2.92"
"111121","13","13","12","1","7","2.92"
"111394","17","17","15","2","8","2.92"
"111420","10","10","8","2","7","2.92"
"111450","17","17","14","3","11","2.92"
"111651","13","13","11","2","6","2.92"
"111683","14","14","11","3","9","2.92"
"111726","17","17","15","2","8","2.92"
"111852","17","17","17","0","12","2.92"
"111861","13","13","10","3","9","2.92"
"111864","18","18","15","3","9","2.92"
"111900","17","17","17","0","16","2.92"
"112088","10","10","10","0","7","2.92"
"112197","14","14","11","3","7","2.92"
"112370","11","11","10","1","9","2.92"
"112798","18","18","15","3","9","2.92"
"112854","13","13","13","0","7","2.92"
"112922","12","12","10","2","7","2.92"
"113047","12","12","12","0","9","2.92"
"113081","11","11","10","1","7","2.92"
"113132","13","13","11","2","9","2.92"
"113313","11","11","9","2","7","2.92"
"113460","15","15","15","0","10","2.92"
"113517","15","15","15","0","11","2.92"
"113523","15","15","14","1","11","2.92"
"113640","15","15","14","1","9","2.92"
"113850","14","14","14","0","8","2.92"
"113878","13","13","11","2","9","2.92"
"114054","9","9","8","1","6","2.92"
"114132","18","18","14","4","9","2.92"
"114228","21","21","19","2","12","2.92"
"114287","13","13","12","1","10","2.92"
"114356","18","18","15","3","13","2.92"
"114439","14","14","14","0","10","2.92"
"114479","13","13","12","1","10","2.92"
"114481","13","13","12","1","7","2.92"
"114526","14","14","11","3","8","2.92"
"114592","14","14","11","3","9","2.92"
"114612","17","17","17","0","12","2.92"
"114628","14","14","12","2","9","2.92"
"114695","13","13","11","2","9","2.92"
"114743","12","12","10","2","8","2.92"
"114825","19","19","19","0","16","2.92"
"114851","12","12","11","1","10","2.92"
"114874","16","16","12","4","7","2.92"
"114905","15","15","13","2","7","2.92"
"115236","13","13","13","0","10","2.92"
"115390","13","13","9","4","8","2.92"
"115590","15","15","13","2","8","2.92"
"115813","11","11","10","1","10","2.92"
"115942","17","17","14","3","7","2.92"
"116047","11","11","10","1","7","2.92"
"116057","12","12","12","0","10","2.92"
"116068","16","16","15","1","8","2.92"
"116122","13","13","11","2","7","2.92"
"116255","13","13","12","1","6","2.92"
"116268","10","10","9","1","7","2.92"
"116330","13","13","11","2","7","2.92"
"116334","13","13","13","0","7","2.92"
"116428","15","15","14","1","10","2.92"
"116531","18","18","16","2","15","2.92"
"116788","15","15","14","1","8","2.92"
"116808","15","14","14","1","9","2.92"
"116869","16","16","15","1","9","2.92"
"117098","16","16","14","2","11","2.92"
"117150","19","19","17","2","10","2.92"
"117226","19","19","14","5","11","2.92"
"117323","15","15","13","2","7","2.92"
"117398","18","18","17","1","7","2.92"
"100048","21","21","19","2","13","2.91"
"100706","20","20","19","1","15","2.91"
"103218","20","20","19","1","15","2.91"
"104719","20","20","19","1","15","2.91"
"105864","21","21","21","0","14","2.91"
"106227","20","20","18","2","15","2.91"
"106723","15","15","15","0","13","2.91"
"108104","18","18","17","1","14","2.91"
"109410","20","20","18","2","15","2.91"
"110571","18","18","17","1","15","2.91"
"111597","22","22","19","3","13","2.91"
"116292","21","21","20","1","16","2.91"
"100018","13","13","13","0","10","2.90"
"100304","14","14","13","1","9","2.90"
"100312","11","11","9","2","7","2.90"
"100353","17","17","14","3","12","2.90"
"100400","13","13","12","1","6","2.90"
"100453","15","15","13","2","11","2.90"
"100542","15","15","12","3","9","2.90"
"100697","13","13","12","1","9","2.90"
"100735","21","21","19","2","14","2.90"
"100831","22","22","21","1","18","2.90"
"100842","12","12","10","2","7","2.90"
"100886","9","9","9","0","7","2.90"
"101132","12","12","10","2","8","2.90"
"101182","8","8","7","1","6","2.90"
"101302","10","10","10","0","6","2.90"
"101393","14","14","12","2","7","2.90"
"101603","15","15","14","1","7","2.90"
"101729","14","14","14","0","13","2.90"
"101915","13","13","13","0","6","2.90"
"101989","23","23","21","2","18","2.90"
"102057","15","15","15","0","12","2.90"
"102073","13","13","12","1","11","2.90"
"102193","11","11","11","0","7","2.90"
"102352","8","8","7","1","6","2.90"
"102368","19","19","16","3","10","2.90"
"102698","12","12","12","0","6","2.90"
"102845","11","11","11","0","6","2.90"
"102878","14","14","12","2","9","2.90"
"102964","9","9","8","1","6","2.90"
"103098","19","19","18","1","12","2.90"
"103099","8","8","8","0","6","2.90"
"103131","17","17","15","2","9","2.90"
"103154","16","16","13","3","7","2.90"
"103161","17","17","15","2","12","2.90"
"103429","12","12","12","0","6","2.90"
"103480","10","10","10","0","9","2.90"
"103502","13","13","12","1","7","2.90"
"103572","14","14","11","3","7","2.90"
"103646","13","13","12","1","7","2.90"
"103722","8","8","7","1","7","2.90"
"103819","16","16","14","2","11","2.90"
"103894","23","23","20","3","16","2.90"
"103921","13","13","11","2","6","2.90"
"103954","21","21","21","0","16","2.90"
"104003","11","11","10","1","8","2.90"
"104014","16","16","16","0","12","2.90"
"104150","10","10","10","0","6","2.90"
"104593","17","17","14","3","7","2.90"
"104640","21","21","20","1","13","2.90"
"104768","17","17","14","3","9","2.90"
"104906","16","16","14","2","8","2.90"
"104907","24","24","21","3","16","2.90"
"105037","15","15","14","1","6","2.90"
"105135","15","15","13","2","10","2.90"
"105304","10","10","9","1","8","2.90"
"105350","16","16","14","2","9","2.90"
"105471","16","16","14","2","9","2.90"
"105812","14","14","14","0","8","2.90"
"106118","19","19","16","3","13","2.90"
"106251","12","12","10","2","8","2.90"
"106419","16","16","15","1","11","2.90"
"106620","9","9","9","0","7","2.90"
"106657","11","11","10","1","7","2.90"
"106961","26","26","25","1","19","2.90"
"107103","14","14","12","2","11","2.90"
"107111","14","14","13","1","10","2.90"
"107142","19","19","16","3","7","2.90"
"107205","13","13","12","1","8","2.90"
"107211","16","16","15","1","10","2.90"
"107248","14","14","13","1","13","2.90"
"107267","12","12","11","1","7","2.90"
"107338","25","25","21","4","13","2.90"
"107372","14","14","13","1","9","2.90"
"107482","16","16","13","3","6","2.90"
"107544","10","10","9","1","6","2.90"
"107566","14","14","14","0","11","2.90"
"107595","12","12","9","3","6","2.90"
"107700","15","15","14","1","8","2.90"
"107718","22","22","20","2","12","2.90"
"107740","16","16","13","3","6","2.90"
"107764","19","19","18","1","15","2.90"
"107765","13","13","13","0","10","2.90"
"107869","14","14","12","2","7","2.90"
"107976","18","18","18","0","12","2.90"
"107990","14","14","11","3","6","2.90"
"108048","10","10","10","0","8","2.90"
"108079","9","9","8","1","7","2.90"
"108153","20","20","20","0","13","2.90"
"108355","10","10","9","1","6","2.90"
"108455","17","16","17","0","12","2.90"
"108658","17","17","14","3","9","2.90"
"108829","10","10","9","1","7","2.90"
"109075","20","20","17","3","11","2.90"
"109189","19","19","16","3","12","2.90"
"109316","13","13","13","0","8","2.90"
"109459","14","14","12","2","7","2.90"
"109521","18","18","17","1","6","2.90"
"109534","11","11","11","0","9","2.90"
"109558","14","14","13","1","8","2.90"
"109577","16","16","16","0","14","2.90"
"109597","12","12","10","2","7","2.90"
"109706","15","15","12","3","6","2.90"
"109779","15","15","15","0","9","2.90"
"109844","10","10","10","0","6","2.90"
"110120","11","11","10","1","9","2.90"
"110361","10","10","9","1","6","2.90"
"110411","14","14","13","1","6","2.90"
"110586","18","18","15","3","11","2.90"
"110764","14","14","13","1","8","2.90"
"110791","10","10","9","1","7","2.90"
"111129","15","15","14","1","9","2.90"
"111152","13","13","11","2","8","2.90"
"111153","9","9","8","1","7","2.90"
"111457","21","21","19","2","13","2.90"
"111585","13","13","13","0","7","2.90"
"111598","15","15","14","1","7","2.90"
"111627","10","10","9","1","6","2.90"
"111630","19","19","18","1","7","2.90"
"111895","15","15","15","0","11","2.90"
"111926","16","16","16","0","11","2.90"
"112098","10","10","10","0","6","2.90"
"112179","17","17","17","0","13","2.90"
"112286","15","15","14","1","8","2.90"
"112296","17","17","16","1","7","2.90"
"112619","21","21","15","6","11","2.90"
"112625","16","16","13","3","8","2.90"
"112822","14","14","11","3","6","2.90"
"112859","17","17","16","1","10","2.90"
"113013","15","15","11","4","6","2.90"
"113153","12","12","11","1","6","2.90"
"113168","10","10","10","0","6","2.90"
"113178","12","12","11","1","9","2.90"
"113193","14","14","12","2","10","2.90"
"113367","11","11","9","2","6","2.90"
"113471","13","13","12","1","8","2.90"
"113542","13","13","11","2","7","2.90"
"113562","17","17","17","0","15","2.90"
"113576","14","14","12","2","7","2.90"
"113608","15","15","14","1","6","2.90"
"113664","12","12","10","2","7","2.90"
"113665","15","15","15","0","6","2.90"
"113689","23","23","22","1","15","2.90"
"113693","22","22","21","1","18","2.90"
"113695","15","15","14","1","6","2.90"
"113704","12","12","11","1","8","2.90"
"113879","12","12","12","0","6","2.90"
"113937","12","12","12","0","9","2.90"
"114059","15","15","13","2","12","2.90"
"114158","17","17","16","1","12","2.90"
"114249","16","16","16","0","13","2.90"
"114476","12","12","11","1","6","2.90"
"114603","15","15","14","1","9","2.90"
"114751","12","12","11","1","7","2.90"
"114855","14","14","12","2","7","2.90"
"114928","11","11","9","2","7","2.90"
"115020","10","10","10","0","8","2.90"
"115179","15","15","12","3","7","2.90"
"115190","18","18","17","1","12","2.90"
"115225","11","11","10","1","6","2.90"
"115489","10","10","10","0","7","2.90"
"115687","12","12","10","2","6","2.90"
"115781","17","17","14","3","7","2.90"
"115841","13","13","10","3","6","2.90"
"116033","9","9","9","0","7","2.90"
"116136","15","15","14","1","9","2.90"
"116320","9","9","8","1","6","2.90"
"116444","13","13","11","2","6","2.90"
"116455","13","13","12","1","9","2.90"
"116699","18","18","16","2","13","2.90"
"116781","20","19","19","1","15","2.90"
"116968","9","9","7","2","6","2.90"
"117034","11","11","9","2","7","2.90"
"117613","22","22","18","4","14","2.90"
"100053","24","24","22","2","18","2.89"
"100066","9","9","9","0","5","2.89"
"100859","15","15","14","1","10","2.89"
"100953","13","13","9","4","6","2.89"
"101043","21","21","18","3","12","2.89"
"101139","15","15","13","2","10","2.89"
"101266","15","15","11","4","8","2.89"
"101309","11","11","11","0","8","2.89"
"101312","19","19","18","1","13","2.89"
"101344","14","14","13","1","11","2.89"
"101388","11","11","10","1","8","2.89"
"102169","13","13","11","2","8","2.89"
"102270","11","11","11","0","7","2.89"
"102645","13","13","12","1","9","2.89"
"103142","14","14","13","1","10","2.89"
"103752","16","16","12","4","8","2.89"
"103767","15","15","14","1","6","2.89"
"103802","16","16","15","1","12","2.89"
"104769","12","12","9","3","8","2.89"
"104772","13","13","10","3","5","2.89"
"104938","12","12","9","3","8","2.89"
"104989","10","10","9","1","8","2.89"
"105210","12","12","12","0","11","2.89"
"105231","15","15","14","1","12","2.89"
"105780","14","14","14","0","6","2.89"
"105797","18","18","17","1","9","2.89"
"105810","17","17","16","1","12","2.89"
"106016","18","18","15","3","13","2.89"
"106067","17","17","16","1","14","2.89"
"106477","18","18","18","0","12","2.89"
"106485","15","15","11","4","8","2.89"
"106885","15","15","15","0","11","2.89"
"107054","14","14","14","0","9","2.89"
"107475","13","13","13","0","9","2.89"
"108449","15","15","13","2","10","2.89"
"108495","12","12","12","0","11","2.89"
"108504","9","9","8","1","7","2.89"
"108540","20","20","16","4","10","2.89"
"108713","9","9","9","0","9","2.89"
"109111","14","14","12","2","10","2.89"
"109227","13","13","13","0","9","2.89"
"109908","14","14","10","4","8","2.89"
"110308","21","21","19","2","15","2.89"
"110337","12","12","9","3","5","2.89"
"110428","14","14","14","0","10","2.89"
"110823","14","14","14","0","8","2.89"
"110841","19","19","19","0","14","2.89"
"110922","14","14","12","2","6","2.89"
"111160","16","16","14","2","14","2.89"
"111329","16","16","13","3","11","2.89"
"111354","10","10","10","0","9","2.89"
"111386","13","12","12","1","8","2.89"
"112013","15","15","13","2","11","2.89"
"112225","23","23","21","2","15","2.89"
"112253","9","9","8","1","6","2.89"
"112401","10","10","10","0","8","2.89"
"112665","17","17","14","3","11","2.89"
"112669","13","13","10","3","9","2.89"
"112675","14","14","12","2","6","2.89"
"112710","15","15","15","0","10","2.89"
"113172","15","15","14","1","9","2.89"
"113285","14","14","13","1","10","2.89"
"113679","20","20","14","6","12","2.89"
"113996","20","20","17","3","10","2.89"
"114500","14","14","14","0","10","2.89"
"114632","16","16","14","2","8","2.89"
"114692","14","14","13","1","11","2.89"
"114712","22","22","21","1","13","2.89"
"114726","22","22","18","4","11","2.89"
"114804","15","15","14","1","11","2.89"
"115201","25","25","24","1","19","2.89"
"115725","17","17","15","2","11","2.89"
"116239","12","12","12","0","10","2.89"
"116519","14","14","12","2","9","2.89"
"116900","16","16","14","2","13","2.89"
"117456","14","14","12","2","7","2.89"
"117474","15","15","13","2","12","2.89"
"100282","14","14","10","4","5","2.88"
"100413","15","15","13","2","11","2.88"
"100423","10","10","9","1","7","2.88"
"100424","18","18","18","0","7","2.88"
"100592","14","14","10","4","9","2.88"
"100636","15","15","14","1","10","2.88"
"100826","16","16","14","2","11","2.88"
"100851","15","15","15","0","12","2.88"
"101040","20","20","18","2","13","2.88"
"101198","11","11","9","2","7","2.88"
"101209","17","17","15","2","10","2.88"
"101303","13","13","11","2","6","2.88"
"101441","16","16","13","3","9","2.88"
"101759","17","17","15","2","12","2.88"
"102038","15","15","13","2","7","2.88"
"102075","8","8","7","1","5","2.88"
"102080","19","19","17","2","10","2.88"
"102370","16","16","14","2","11","2.88"
"102377","16","16","14","2","12","2.88"
"102620","9","9","9","0","6","2.88"
"102646","17","17","14","3","8","2.88"
"103719","13","13","13","0","10","2.88"
"103733","12","12","12","0","12","2.88"
"103806","15","15","13","2","7","2.88"
"103860","21","21","18","3","12","2.88"
"103869","13","13","11","2","7","2.88"
"104095","18","18","17","1","12","2.88"
"104138","10","10","7","3","5","2.88"
"104239","16","16","12","4","7","2.88"
"104276","14","14","13","1","13","2.88"
"104342","17","17","15","2","10","2.88"
"104366","23","23","22","1","16","2.88"
"104368","10","10","9","1","5","2.88"
"104601","16","16","15","1","11","2.88"
"104632","14","14","14","0","10","2.88"
"104657","13","13","12","1","9","2.88"
"104784","15","15","13","2","5","2.88"
"105071","7","7","7","0","5","2.88"
"105159","14","14","12","2","5","2.88"
"105292","15","15","14","1","12","2.88"
"105314","17","17","15","2","11","2.88"
"105351","12","12","11","1","6","2.88"
"105635","14","14","11","3","5","2.88"
"105639","13","13","13","0","7","2.88"
"105794","16","16","15","1","11","2.88"
"105801","13","13","11","2","8","2.88"
"105866","12","12","12","0","9","2.88"
"105874","17","17","16","1","11","2.88"
"105976","12","12","11","1","9","2.88"
"106121","20","20","18","2","13","2.88"
"106145","19","19","18","1","14","2.88"
"106151","12","12","12","0","10","2.88"
"106226","17","17","15","2","9","2.88"
"106367","11","11","11","0","7","2.88"
"106481","17","17","14","3","10","2.88"
"106604","19","19","19","0","12","2.88"
"106743","12","12","12","0","11","2.88"
"106799","14","14","11","3","6","2.88"
"106816","14","14","10","4","5","2.88"
"106863","10","10","9","1","6","2.88"
"106973","15","15","14","1","14","2.88"
"107019","18","18","16","2","13","2.88"
"107299","7","7","7","0","6","2.88"
"107414","10","10","9","1","6","2.88"
"107645","15","15","14","1","11","2.88"
"107686","23","23","21","2","14","2.88"
"107712","24","24","23","1","15","2.88"
"107829","17","17","15","2","11","2.88"
"107965","17","17","16","1","13","2.88"
"108009","15","15","15","0","13","2.88"
"108240","14","14","14","0","13","2.88"
"108393","17","17","16","1","9","2.88"
"108406","17","17","17","0","12","2.88"
"108598","10","10","10","0","6","2.88"
"108867","12","12","12","0","5","2.88"
"108899","17","17","15","2","10","2.88"
"108952","14","14","14","0","11","2.88"
"108953","20","20","17","3","13","2.88"
"108956","13","13","11","2","6","2.88"
"109146","14","14","13","1","10","2.88"
"109262","14","14","13","1","11","2.88"
"109555","17","17","14","3","7","2.88"
"109649","18","18","17","1","13","2.88"
"109653","15","15","10","5","6","2.88"
"109739","13","13","12","1","7","2.88"
"109786","17","17","16","1","11","2.88"
"110100","17","17","17","0","10","2.88"
"110148","16","16","15","1","12","2.88"
"110203","15","15","15","0","10","2.88"
"110427","17","17","16","1","10","2.88"
"110445","9","9","9","0","5","2.88"
"110463","15","15","13","2","8","2.88"
"110665","20","20","17","3","13","2.88"
"110696","12","12","10","2","6","2.88"
"110761","15","15","13","2","8","2.88"
"110778","12","12","11","1","5","2.88"
"110938","8","8","8","0","7","2.88"
"111260","8","8","8","0","5","2.88"
"111334","14","14","12","2","10","2.88"
"111398","14","14","11","3","9","2.88"
"111637","11","11","10","1","7","2.88"
"111638","12","12","10","2","6","2.88"
"111816","13","13","13","0","11","2.88"
"111829","11","11","7","4","5","2.88"
"111874","12","12","11","1","6","2.88"
"111947","14","14","13","1","10","2.88"
"111976","10","10","9","1","5","2.88"
"112089","11","11","10","1","5","2.88"
"112159","15","15","15","0","9","2.88"
"112270","12","12","10","2","6","2.88"
"112302","13","13","11","2","9","2.88"
"112471","21","21","18","3","15","2.88"
"112586","25","25","24","1","18","2.88"
"112633","15","15","13","2","11","2.88"
"112679","17","17","10","7","5","2.88"
"112686","16","16","14","2","11","2.88"
"112846","14","14","13","1","12","2.88"
"113001","16","16","13","3","8","2.88"
"113386","10","10","7","3","5","2.88"
"113454","16","16","13","3","11","2.88"
"113472","12","12","8","4","6","2.88"
"113700","19","19","16","3","11","2.88"
"113756","16","16","13","3","11","2.88"
"113895","8","8","8","0","6","2.88"
"113975","8","8","8","0","6","2.88"
"114110","13","13","12","1","9","2.88"
"114127","8","8","8","0","6","2.88"
"114136","18","18","16","2","11","2.88"
"114237","13","13","12","1","8","2.88"
"114265","19","19","16","3","12","2.88"
"114395","23","23","22","1","13","2.88"
"114505","19","19","18","1","12","2.88"
"114530","13","13","13","0","9","2.88"
"114658","20","20","17","3","11","2.88"
"114875","15","15","15","0","11","2.88"
"115005","10","10","9","1","5","2.88"
"115046","23","23","19","4","17","2.88"
"115137","13","13","9","4","5","2.88"
"115269","12","12","12","0","6","2.88"
"115272","15","15","12","3","8","2.88"
"115367","14","14","13","1","12","2.88"
"115444","8","8","5","3","5","2.88"
"115447","13","13","13","0","9","2.88"
"115603","15","15","13","2","10","2.88"
"115941","17","17","17","0","11","2.88"
"115980","13","13","11","2","5","2.88"
"116023","18","18","13","5","10","2.88"
"116025","14","14","14","0","11","2.88"
"116038","12","12","9","3","7","2.88"
"116188","9","9","9","0","7","2.88"
"116275","21","21","18","3","12","2.88"
"116302","15","15","15","0","10","2.88"
"116468","17","17","14","3","11","2.88"
"116559","15","15","14","1","12","2.88"
"116684","25","25","25","0","22","2.88"
"116691","16","16","15","1","10","2.88"
"116952","7","7","7","0","5","2.88"
"117268","19","19","18","1","17","2.88"
"117300","7","7","6","1","5","2.88"
"117333","11","11","11","0","5","2.88"
"117386","18","18","15","3","12","2.88"
"117441","11","11","11","0","5","2.88"
"117468","12","12","9","3","5","2.88"
"100095","15","15","13","2","7","2.87"
"100555","14","14","13","1","12","2.87"
"101425","11","11","11","0","7","2.87"
"101881","9","9","8","1","7","2.87"
"102059","15","15","14","1","8","2.87"
"102760","17","17","17","0","14","2.87"
"102973","15","15","13","2","10","2.87"
"104687","20","20","19","1","14","2.87"
"104786","13","13","11","2","7","2.87"
"104795","24","24","21","3","18","2.87"
"105095","15","15","14","1","7","2.87"
"105233","14","14","14","0","9","2.87"
"105975","19","19","16","3","9","2.87"
"107203","17","17","17","0","17","2.87"
"107313","15","15","15","0","9","2.87"
"107874","10","10","9","1","8","2.87"
"108327","19","19","16","3","12","2.87"
"109217","23","23","20","3","17","2.87"
"109581","18","18","17","1","8","2.87"
"109676","14","14","13","1","8","2.87"
"110143","14","14","11","3","7","2.87"
"110287","12","12","10","2","8","2.87"
"110302","20","20","19","1","14","2.87"
"110397","14","14","14","0","10","2.87"
"110711","14","14","13","1","8","2.87"
"110749","20","20","16","4","10","2.87"
"111253","16","15","16","0","13","2.87"
"111360","18","18","17","1","10","2.87"
"111367","15","15","13","2","9","2.87"
"111379","21","21","19","2","15","2.87"
"111808","11","11","9","2","7","2.87"
"111815","16","16","16","0","9","2.87"
"112040","12","12","11","1","9","2.87"
"112690","14","14","12","2","8","2.87"
"112800","20","20","19","1","14","2.87"
"113074","15","15","14","1","9","2.87"
"113384","12","12","12","0","9","2.87"
"114385","13","13","11","2","8","2.87"
"115502","11","11","11","0","8","2.87"
"115895","21","21","21","0","17","2.87"
"115953","16","16","14","2","8","2.87"
"116103","18","18","17","1","15","2.87"
"116344","15","15","14","1","11","2.87"
"116576","14","14","13","1","7","2.87"
"116920","18","18","17","1","13","2.87"
"117090","15","15","13","2","9","2.87"
"117272","19","19","18","1","13","2.87"
"117274","18","18","18","0","13","2.87"
"117294","12","12","11","1","7","2.87"
"100038","15","15","15","0","11","2.86"
"100233","12","12","9","3","7","2.86"
"100496","15","15","14","1","10","2.86"
"100733","16","16","13","3","11","2.86"
"100912","14","14","14","0","11","2.86"
"100922","17","16","14","3","12","2.86"
"101032","17","17","14","3","9","2.86"
"101301","11","11","11","0","9","2.86"
"101345","16","16","16","0","12","2.86"
"101512","20","20","20","0","11","2.86"
"101880","17","17","16","1","12","2.86"
"101986","10","10","10","0","7","2.86"
"102084","12","12","12","0","10","2.86"
"102126","18","18","17","1","11","2.86"
"102437","17","17","17","0","14","2.86"
"102527","12","12","12","0","11","2.86"
"102596","13","13","13","0","9","2.86"
"102676","17","17","17","0","12","2.86"
"102833","16","16","15","1","12","2.86"
"103766","16","16","14","2","10","2.86"
"103778","14","14","10","4","8","2.86"
"103966","20","20","17","3","10","2.86"
"104042","17","17","17","0","11","2.86"
"104147","9","9","8","1","8","2.86"
"104331","17","17","14","3","12","2.86"
"104345","12","12","11","1","9","2.86"
"104438","12","12","11","1","9","2.86"
"104490","23","23","21","2","14","2.86"
"104500","19","19","16","3","10","2.86"
"104700","14","14","10","4","7","2.86"
"104884","15","15","14","1","10","2.86"
"104923","19","19","18","1","12","2.86"
"105078","13","13","11","2","8","2.86"
"105581","13","13","13","0","8","2.86"
"105920","15","15","14","1","9","2.86"
"106209","18","18","16","2","9","2.86"
"106265","16","16","15","1","12","2.86"
"106301","24","24","20","4","16","2.86"
"106427","13","13","11","2","9","2.86"
"106495","9","9","9","0","8","2.86"
"106571","16","16","16","0","9","2.86"
"106771","21","21","18","3","14","2.86"
"106943","15","15","13","2","8","2.86"
"107176","18","17","16","2","10","2.86"
"107183","17","17","16","1","13","2.86"
"107438","18","18","16","2","11","2.86"
"107469","17","17","16","1","11","2.86"
"107491","16","16","13","3","8","2.86"
"107631","12","12","11","1","7","2.86"
"107634","15","15","13","2","11","2.86"
"107644","16","16","14","2","7","2.86"
"107756","23","23","20","3","11","2.86"
"107780","14","14","13","1","10","2.86"
"108095","13","13","12","1","10","2.86"
"108131","12","12","9","3","8","2.86"
"108231","17","17","16","1","10","2.86"
"108299","16","16","14","2","11","2.86"
"108330","18","18","15","3","11","2.86"
"108388","12","12","11","1","9","2.86"
"108621","9","9","9","0","9","2.86"
"108665","14","14","14","0","10","2.86"
"108964","16","16","15","1","9","2.86"
"109042","17","17","15","2","10","2.86"
"109153","15","15","14","1","10","2.86"
"109261","16","16","16","0","13","2.86"
"109391","19","19","18","1","15","2.86"
"109416","17","17","15","2","10","2.86"
"109487","17","17","14","3","8","2.86"
"109547","10","10","10","0","9","2.86"
"109849","17","17","16","1","13","2.86"
"110043","12","12","10","2","10","2.86"
"110090","13","13","13","0","10","2.86"
"110136","15","15","13","2","10","2.86"
"110458","13","13","13","0","8","2.86"
"110490","19","19","18","1","11","2.86"
"110555","14","14","13","1","8","2.86"
"110581","14","14","13","1","8","2.86"
"110648","19","19","18","1","13","2.86"
"110740","15","15","14","1","12","2.86"
"110777","15","15","14","1","10","2.86"
"110857","17","16","15","2","12","2.86"
"111065","13","13","11","2","9","2.86"
"111177","15","15","15","0","14","2.86"
"111197","21","21","20","1","13","2.86"
"111361","17","17","17","0","14","2.86"
"111620","18","18","16","2","8","2.86"
"111662","21","21","20","1","13","2.86"
"111712","14","14","12","2","10","2.86"
"111821","18","18","17","1","14","2.86"
"111997","17","17","16","1","12","2.86"
"112148","14","14","13","1","9","2.86"
"112187","13","13","11","2","10","2.86"
"112247","13","13","11","2","8","2.86"
"112347","15","15","14","1","10","2.86"
"112629","14","14","12","2","9","2.86"
"112760","15","15","12","3","9","2.86"
"113075","11","11","11","0","9","2.86"
"113220","14","14","11","3","9","2.86"
"113271","15","15","13","2","10","2.86"
"113343","11","11","11","0","7","2.86"
"113510","9","9","9","0","9","2.86"
"113525","15","15","14","1","10","2.86"
"113570","13","13","11","2","9","2.86"
"113650","13","13","12","1","10","2.86"
"113725","16","16","15","1","9","2.86"
"113750","13","13","12","1","8","2.86"
"113765","17","17","16","1","13","2.86"
"113769","15","15","15","0","11","2.86"
"113771","11","11","11","0","8","2.86"
"113829","17","17","14","3","10","2.86"
"113889","12","12","11","1","9","2.86"
"113906","15","15","14","1","10","2.86"
"114227","14","14","12","2","8","2.86"
"114258","13","13","11","2","8","2.86"
"114381","19","19","18","1","11","2.86"
"114839","17","17","15","2","11","2.86"
"114889","16","16","15","1","9","2.86"
"114926","14","14","14","0","10","2.86"
"114960","12","12","11","1","9","2.86"
"114983","19","19","17","2","12","2.86"
"115090","13","13","13","0","9","2.86"
"115452","16","16","15","1","10","2.86"
"115664","19","19","17","2","13","2.86"
"115666","13","13","10","3","8","2.86"
"115743","8","8","7","1","7","2.86"
"115803","15","15","15","0","11","2.86"
"115819","15","15","15","0","12","2.86"
"115955","13","13","12","1","9","2.86"
"116174","18","18","16","2","11","2.86"
"116290","15","15","14","1","10","2.86"
"116324","21","21","17","4","11","2.86"
"116347","16","16","13","3","10","2.86"
"116363","20","20","20","0","12","2.86"
"116364","17","17","15","2","12","2.86"
"116389","18","18","16","2","10","2.86"
"116422","10","10","10","0","8","2.86"
"116560","14","14","13","1","10","2.86"
"116785","11","11","11","0","8","2.86"
"116876","11","11","11","0","8","2.86"
"116890","18","18","16","2","10","2.86"
"116893","15","15","12","3","10","2.86"
"117189","13","13","11","2","9","2.86"
"117391","18","18","17","1","13","2.86"
"117399","17","17","15","2","8","2.86"
"117565","12","12","12","0","8","2.86"
"100147","15","15","14","1","12","2.85"
"100767","13","13","12","1","11","2.85"
"100913","19","19","18","1","13","2.85"
"102357","21","21","20","1","12","2.85"
"102995","16","16","15","1","12","2.85"
"103945","16","16","14","2","13","2.85"
"103977","19","19","19","0","12","2.85"
"104319","15","15","14","1","11","2.85"
"104650","15","15","14","1","11","2.85"
"105162","12","12","11","1","8","2.85"
"106157","17","17","17","0","11","2.85"
"106421","13","13","12","1","9","2.85"
"106430","15","15","13","2","8","2.85"
"107388","16","16","15","1","11","2.85"
"108497","14","14","12","2","9","2.85"
"108675","12","12","12","0","8","2.85"
"108799","15","15","15","0","12","2.85"
"109058","22","22","19","3","16","2.85"
"109625","13","13","12","1","10","2.85"
"110035","17","17","17","0","12","2.85"
"110416","17","17","16","1","11","2.85"
"110518","16","16","16","0","13","2.85"
"110570","17","17","16","1","14","2.85"
"110577","12","12","10","2","9","2.85"
"111511","14","14","14","0","11","2.85"
"111529","18","18","18","0","13","2.85"
"113682","15","14","14","1","12","2.85"
"113986","18","18","18","0","13","2.85"
"113989","16","16","14","2","11","2.85"
"114188","19","19","18","1","13","2.85"
"115200","17","17","14","3","10","2.85"
"115458","17","17","15","2","11","2.85"
"116442","27","27","24","3","13","2.85"
"116487","26","26","23","3","17","2.85"
"117064","16","16","14","2","12","2.85"
"117315","19","19","17","2","13","2.85"
"100029","16","16","14","2","11","2.84"
"100709","21","21","19","2","12","2.84"
"100798","17","17","13","4","11","2.84"
"101184","19","19","16","3","9","2.84"
"101689","23","23","20","3","14","2.84"
"103482","24","24","24","0","18","2.84"
"103692","9","9","7","2","4","2.84"
"105673","19","19","18","1","12","2.84"
"106717","14","14","14","0","12","2.84"
"108806","20","20","18","2","12","2.84"
"108864","18","18","15","3","8","2.84"
"110440","19","19","17","2","13","2.84"
"110531","21","21","21","0","15","2.84"
"111460","17","17","16","1","12","2.84"
"112023","14","14","14","0","8","2.84"
"112306","16","16","16","0","13","2.84"
"112578","19","19","18","1","14","2.84"
"112634","7","7","6","1","4","2.84"
"112729","17","17","16","1","11","2.84"
"113102","19","19","18","1","13","2.84"
"113527","11","11","10","1","7","2.84"
"114392","14","14","13","1","8","2.84"
"114843","15","15","14","1","9","2.84"
"117622","19","19","16","3","11","2.84"
"100040","18","18","17","1","14","2.83"
"100093","11","11","9","2","8","2.83"
"100163","11","11","11","0","6","2.83"
"100237","12","12","12","0","9","2.83"
"100277","14","14","14","0","8","2.83"
"100280","17","17","16","1","12","2.83"
"100316","14","14","13","1","10","2.83"
"100337","22","22","21","1","15","2.83"
"100373","16","16","15","1","7","2.83"
"100374","13","13","13","0","9","2.83"
"100408","9","9","8","1","8","2.83"
"100412","13","13","11","2","8","2.83"
"100510","13","13","11","2","6","2.83"
"100599","6","6","4","2","4","2.83"
"100622","10","10","9","1","7","2.83"
"100669","14","14","10","4","8","2.83"
"100699","11","11","11","0","10","2.83"
"100711","10","10","10","0","7","2.83"
"100715","12","12","10","2","7","2.83"
"100770","13","13","11","2","8","2.83"
"100893","16","16","15","1","6","2.83"
"100957","8","8","8","0","7","2.83"
"101019","13","13","11","2","8","2.83"
"101239","9","9","8","1","6","2.83"
"101260","14","14","12","2","7","2.83"
"101278","11","11","9","2","7","2.83"
"101543","14","14","13","1","9","2.83"
"101586","18","18","16","2","12","2.83"
"101635","12","12","11","1","8","2.83"
"101679","14","14","12","2","8","2.83"
"101717","16","16","15","1","10","2.83"
"101772","16","16","13","3","7","2.83"
"101781","13","13","10","3","6","2.83"
"101808","13","13","12","1","6","2.83"
"101872","11","11","10","1","7","2.83"
"101964","9","9","8","1","7","2.83"
"101965","16","16","15","1","12","2.83"
"101976","15","15","12","3","10","2.83"
"102049","15","15","14","1","9","2.83"
"102232","15","15","12","3","6","2.83"
"102268","23","23","23","0","17","2.83"
"102358","15","15","13","2","10","2.83"
"102387","7","7","6","1","4","2.83"
"102388","14","14","13","1","8","2.83"
"102409","14","14","11","3","6","2.83"
"102448","15","15","13","2","10","2.83"
"102474","10","10","10","0","4","2.83"
"102494","17","17","14","3","12","2.83"
"102499","14","14","14","0","9","2.83"
"102551","19","19","17","2","9","2.83"
"102635","13","13","11","2","7","2.83"
"102670","14","14","13","1","7","2.83"
"102724","7","7","6","1","6","2.83"
"102752","11","11","9","2","7","2.83"
"102909","13","13","11","2","9","2.83"
"102990","9","9","9","0","7","2.83"
"103091","10","10","9","1","6","2.83"
"103114","15","15","12","3","10","2.83"
"103127","16","16","16","0","10","2.83"
"103128","17","17","15","2","13","2.83"
"103195","10","10","9","1","7","2.83"
"103265","14","14","13","1","11","2.83"
"103329","16","16","15","1","11","2.83"
"103408","12","12","11","1","7","2.83"
"103421","18","18","18","0","11","2.83"
"103492","10","10","10","0","5","2.83"
"103518","15","15","14","1","11","2.83"
"103527","16","16","15","1","11","2.83"
"103607","21","21","18","3","14","2.83"
"103622","13","13","13","0","10","2.83"
"103687","14","14","11","3","10","2.83"
"103702","13","13","11","2","8","2.83"
"103710","12","12","11","1","6","2.83"
"103728","20","20","20","0","14","2.83"
"103838","14","14","14","0","11","2.83"
"103931","19","19","17","2","10","2.83"
"104005","11","11","11","0","8","2.83"
"104288","12","12","10","2","9","2.83"
"104307","12","12","10","2","6","2.83"
"104334","14","14","14","0","7","2.83"
"104447","10","10","10","0","6","2.83"
"104608","15","15","13","2","9","2.83"
"104737","14","14","12","2","9","2.83"
"104868","6","6","5","1","4","2.83"
"104916","15","15","14","1","7","2.83"
"104933","9","9","9","0","6","2.83"
"105026","12","12","11","1","8","2.83"
"105056","12","12","11","1","4","2.83"
"105111","11","11","8","3","6","2.83"
"105140","13","13","10","3","8","2.83"
"105178","13","13","11","2","7","2.83"
"105358","15","15","13","2","8","2.83"
"105393","14","14","12","2","6","2.83"
"105442","10","10","9","1","8","2.83"
"105446","15","15","15","0","10","2.83"
"105489","11","11","10","1","8","2.83"
"105652","13","13","12","1","7","2.83"
"105678","18","18","15","3","6","2.83"
"105686","12","12","12","0","11","2.83"
"105742","14","14","12","2","10","2.83"
"105765","9","9","7","2","6","2.83"
"105772","21","21","18","3","15","2.83"
"105786","12","12","11","1","6","2.83"
"105862","11","11","9","2","7","2.83"
"106048","14","14","12","2","8","2.83"
"106158","10","10","9","1","6","2.83"
"106172","15","15","14","1","10","2.83"
"106190","11","11","10","1","8","2.83"
"106292","14","14","14","0","9","2.83"
"106349","13","13","13","0","11","2.83"
"106473","12","12","11","1","9","2.83"
"106498","14","14","12","2","9","2.83"
"106500","16","16","13","3","10","2.83"
"106556","17","17","15","2","8","2.83"
"106558","9","9","9","0","8","2.83"
"106731","13","13","13","0","6","2.83"
"106796","14","14","14","0","6","2.83"
"106806","13","13","11","2","7","2.83"
"106841","15","15","13","2","9","2.83"
"106846","17","17","15","2","9","2.83"
"106899","13","13","12","1","8","2.83"
"107011","11","11","11","0","7","2.83"
"107038","6","6","5","1","4","2.83"
"107059","11","11","11","0","5","2.83"
"107077","16","16","15","1","10","2.83"
"107095","10","10","9","1","9","2.83"
"107155","10","10","10","0","7","2.83"
"107517","21","21","20","1","15","2.83"
"107531","20","20","17","3","13","2.83"
"107672","8","8","7","1","6","2.83"
"107793","8","8","7","1","5","2.83"
"107815","17","17","13","4","6","2.83"
"107953","17","17","15","2","9","2.83"
"108117","14","14","12","2","6","2.83"
"108196","11","11","11","0","8","2.83"
"108266","9","9","9","0","7","2.83"
"108345","13","13","11","2","9","2.83"
"108390","18","18","17","1","12","2.83"
"108515","15","15","15","0","11","2.83"
"108517","13","13","12","1","11","2.83"
"108538","11","11","10","1","9","2.83"
"108567","12","12","11","1","8","2.83"
"108575","10","10","8","2","7","2.83"
"108582","16","16","15","1","10","2.83"
"108604","13","13","13","0","8","2.83"
"108615","9","9","9","0","4","2.83"
"108798","11","11","8","3","6","2.83"
"108851","12","12","11","1","7","2.83"
"108869","15","15","15","0","11","2.83"
"108880","12","12","10","2","7","2.83"
"108989","19","19","17","2","8","2.83"
"109019","11","11","11","0","9","2.83"
"109022","19","19","17","2","13","2.83"
"109211","14","14","12","2","9","2.83"
"109222","10","10","9","1","6","2.83"
"109265","10","10","10","0","8","2.83"
"109270","14","14","11","3","7","2.83"
"109351","10","10","10","0","9","2.83"
"109389","11","11","10","1","8","2.83"
"109432","16","16","13","3","8","2.83"
"109493","11","11","10","1","8","2.83"
"109539","10","10","10","0","6","2.83"
"109716","11","11","11","0","8","2.83"
"109717","11","11","10","1","7","2.83"
"109770","12","12","11","1","9","2.83"
"109829","12","12","12","0","6","2.83"
"109879","18","18","17","1","10","2.83"
"109907","13","13","12","1","10","2.83"
"109997","12","12","11","1","9","2.83"
"110045","15","15","15","0","10","2.83"
"110153","17","17","14","3","9","2.83"
"110162","15","15","13","2","6","2.83"
"110210","13","13","12","1","9","2.83"
"110355","9","9","9","0","8","2.83"
"110399","11","11","11","0","6","2.83"
"110504","6","6","6","0","4","2.83"
"110507","15","15","14","1","7","2.83"
"110534","10","10","10","0","9","2.83"
"110536","11","11","9","2","6","2.83"
"110541","19","19","17","2","10","2.83"
"110547","10","10","10","0","8","2.83"
"110557","18","18","14","4","10","2.83"
"110578","20","20","17","3","11","2.83"
"110628","17","17","15","2","12","2.83"
"110795","13","13","12","1","8","2.83"
"110816","15","15","14","1","11","2.83"
"110964","17","17","16","1","12","2.83"
"110968","14","14","13","1","10","2.83"
"111291","16","16","15","1","12","2.83"
"111318","13","13","12","1","7","2.83"
"111328","12","12","12","0","8","2.83"
"111350","13","13","11","2","7","2.83"
"111479","12","12","11","1","7","2.83"
"111499","16","16","13","3","9","2.83"
"111528","12","12","12","0","9","2.83"
"111548","13","13","10","3","6","2.83"
"111577","11","11","11","0","6","2.83"
"111635","20","20","17","3","13","2.83"
"111698","8","8","8","0","7","2.83"
"111707","14","14","13","1","12","2.83"
"111766","11","11","8","3","6","2.83"
"111805","6","6","5","1","4","2.83"
"111948","9","9","9","0","4","2.83"
"111966","14","14","11","3","9","2.83"
"112028","11","11","11","0","8","2.83"
"112091","15","15","11","4","5","2.83"
"112127","15","15","13","2","7","2.83"
"112173","14","14","13","1","9","2.83"
"112203","15","15","13","2","10","2.83"
"112311","15","15","14","1","10","2.83"
"112385","8","8","8","0","7","2.83"
"112424","14","14","12","2","11","2.83"
"112640","12","11","10","2","7","2.83"
"112700","14","14","14","0","10","2.83"
"112704","12","12","12","0","6","2.83"
"112722","14","14","10","4","6","2.83"
"112868","13","13","13","0","9","2.83"
"112887","17","17","17","0","13","2.83"
"112945","10","10","9","1","6","2.83"
"112996","12","12","12","0","9","2.83"
"113015","11","11","10","1","7","2.83"
"113064","12","12","11","1","8","2.83"
"113173","9","9","8","1","6","2.83"
"113385","8","8","7","1","6","2.83"
"113415","9","9","9","0","6","2.83"
"113420","10","10","10","0","9","2.83"
"113423","7","7","6","1","4","2.83"
"113461","9","9","7","2","6","2.83"
"113536","9","9","4","5","4","2.83"
"113643","9","9","8","1","7","2.83"
"113897","11","11","11","0","7","2.83"
"113968","14","14","12","2","8","2.83"
"114082","11","11","10","1","8","2.83"
"114231","15","15","15","0","11","2.83"
"114465","15","15","14","1","11","2.83"
"114585","14","14","13","1","8","2.83"
"114918","10","10","9","1","6","2.83"
"114938","12","12","11","1","8","2.83"
"114968","13","13","12","1","11","2.83"
"114975","11","11","9","2","6","2.83"
"114993","17","17","16","1","12","2.83"
"115029","10","10","8","2","6","2.83"
"115098","20","20","18","2","13","2.83"
"115152","16","16","16","0","13","2.83"
"115204","15","15","12","3","7","2.83"
"115209","12","12","12","0","8","2.83"
"115256","11","11","9","2","6","2.83"
"115263","10","10","10","0","8","2.83"
"115337","13","13","12","1","8","2.83"
"115342","13","13","12","1","7","2.83"
"115354","12","12","10","2","5","2.83"
"115400","11","11","9","2","7","2.83"
"115403","12","12","10","2","7","2.83"
"115438","16","16","15","1","13","2.83"
"115474","19","19","16","3","10","2.83"
"115478","17","17","16","1","14","2.83"
"115717","14","14","11","3","10","2.83"
"115730","14","14","12","2","9","2.83"
"115835","16","16","13","3","10","2.83"
"115921","12","12","12","0","9","2.83"
"115931","9","9","8","1","4","2.83"
"115952","14","14","12","2","9","2.83"
"116003","14","14","13","1","10","2.83"
"116035","16","16","14","2","4","2.83"
"116055","9","9","8","1","6","2.83"
"116150","15","15","14","1","12","2.83"
"116151","13","13","12","1","7","2.83"
"116221","20","20","17","3","14","2.83"
"116261","11","11","8","3","6","2.83"
"116289","12","12","10","2","8","2.83"
"116343","9","9","9","0","8","2.83"
"116415","12","12","11","1","7","2.83"
"116492","11","11","11","0","4","2.83"
"116502","13","13","11","2","10","2.83"
"116521","16","16","13","3","7","2.83"
"116524","12","12","11","1","7","2.83"
"116606","13","13","12","1","10","2.83"
"116639","10","10","9","1","8","2.83"
"116718","20","20","18","2","10","2.83"
"116791","10","10","10","0","6","2.83"
"116855","10","10","9","1","8","2.83"
"116856","13","13","12","1","10","2.83"
"116864","15","15","15","0","10","2.83"
"116866","17","17","15","2","10","2.83"
"116942","16","16","15","1","8","2.83"
"116948","13","13","11","2","8","2.83"
"116975","21","21","19","2","14","2.83"
"117066","10","10","7","3","6","2.83"
"117099","15","15","15","0","12","2.83"
"117270","12","12","10","2","7","2.83"
"117406","17","17","14","3","9","2.83"
"117428","15","15","14","1","11","2.83"
"117531","19","19","17","2","11","2.83"
"100105","23","23","20","3","12","2.82"
"102209","14","14","14","0","12","2.82"
"103503","16","16","15","1","13","2.82"
"106290","12","12","12","0","10","2.82"
"106916","17","17","15","2","13","2.82"
"108430","18","18","16","2","12","2.82"
"108893","16","16","16","0","10","2.82"
"109003","24","24","23","1","16","2.82"
"109607","12","12","12","0","11","2.82"
"109807","16","16","15","1","14","2.82"
"111074","12","12","12","0","10","2.82"
"111170","19","19","18","1","12","2.82"
"111271","15","15","13","2","10","2.82"
"111843","15","15","14","1","12","2.82"
"112118","19","19","15","4","11","2.82"
"113195","18","18","16","2","11","2.82"
"113361","17","17","17","0","13","2.82"
"113659","18","18","15","3","11","2.82"
"114060","22","22","20","2","13","2.82"
"115170","13","13","12","1","12","2.82"
"116244","12","12","10","2","10","2.82"
"116327","18","18","16","2","12","2.82"
"116850","15","15","13","2","11","2.82"
"100124","20","20","17","3","11","2.81"
"100333","17","17","16","1","15","2.81"
"100603","16","16","14","2","11","2.81"
"100663","15","15","13","2","9","2.81"
"100806","14","14","14","0","11","2.81"
"100824","20","20","17","3","10","2.81"
"101256","16","16","14","2","10","2.81"
"101317","16","16","14","2","14","2.81"
"101334","16","16","15","1","12","2.81"
"101538","17","17","13","4","11","2.81"
"101699","19","19","18","1","13","2.81"
"101736","13","13","13","0","10","2.81"
"101896","15","15","15","0","12","2.81"
"101901","17","17","16","1","15","2.81"
"102106","14","14","13","1","8","2.81"
"102324","22","22","20","2","16","2.81"
"102408","13","13","11","2","9","2.81"
"102633","11","11","11","0","9","2.81"
"102667","15","15","15","0","11","2.81"
"102959","18","18","17","1","11","2.81"
"103124","17","17","16","1","10","2.81"
"103177","17","17","16","1","11","2.81"
"103255","22","22","18","4","13","2.81"
"103725","15","15","15","0","10","2.81"
"104072","15","15","13","2","9","2.81"
"104430","17","17","15","2","11","2.81"
"104457","14","14","11","3","10","2.81"
"104791","15","15","14","1","9","2.81"
"104821","12","12","12","0","8","2.81"
"104904","14","14","14","0","12","2.81"
"104993","10","10","10","0","9","2.81"
"105058","18","18","16","2","10","2.81"
"105286","12","12","11","1","10","2.81"
"105499","14","14","11","3","9","2.81"
"105578","13","13","13","0","12","2.81"
"105749","20","20","18","2","13","2.81"
"105923","14","14","13","1","10","2.81"
"106100","16","16","16","0","11","2.81"
"106331","14","14","12","2","9","2.81"
"106503","22","22","21","1","14","2.81"
"107524","21","21","19","2","15","2.81"
"107987","14","14","14","0","11","2.81"
"107996","15","15","14","1","10","2.81"
"108121","23","23","21","2","13","2.81"
"108376","18","18","17","1","12","2.81"
"108600","15","15","12","3","10","2.81"
"108755","15","15","13","2","11","2.81"
"108897","16","16","16","0","14","2.81"
"109216","16","16","15","1","12","2.81"
"109398","17","17","16","1","10","2.81"
"109583","22","22","21","1","17","2.81"
"109650","19","19","17","2","11","2.81"
"109726","14","14","14","0","11","2.81"
"109752","17","17","16","1","11","2.81"
"109847","16","16","14","2","10","2.81"
"109881","16","16","16","0","12","2.81"
"110306","11","11","10","1","9","2.81"
"110846","17","17","16","1","12","2.81"
"110965","24","24","22","2","18","2.81"
"111104","19","19","16","3","11","2.81"
"111217","19","19","19","0","13","2.81"
"111546","16","16","16","0","12","2.81"
"111844","12","12","11","1","8","2.81"
"111911","19","19","17","2","14","2.81"
"112093","20","20","19","1","13","2.81"
"112210","16","16","15","1","11","2.81"
"112324","16","16","14","2","11","2.81"
"112893","11","11","9","2","8","2.81"
"113155","15","15","14","1","13","2.81"
"113422","16","16","15","1","11","2.81"
"113537","17","17","16","1","9","2.81"
"113639","14","14","13","1","10","2.81"
"114164","17","17","16","1","12","2.81"
"114252","14","14","14","0","10","2.81"
"114301","17","17","15","2","11","2.81"
"114346","13","13","13","0","9","2.81"
"114404","14","14","13","1","8","2.81"
"115100","14","14","13","1","11","2.81"
"115219","13","13","12","1","9","2.81"
"115351","17","17","16","1","12","2.81"
"115394","17","17","15","2","12","2.81"
"115867","15","15","13","2","10","2.81"
"116126","17","17","16","1","10","2.81"
"116355","16","16","15","1","11","2.81"
"116439","17","17","14","3","10","2.81"
"116447","21","21","20","1","15","2.81"
"116476","16","16","15","1","12","2.81"
"100009","11","11","11","0","7","2.80"
"100100","8","8","7","1","5","2.80"
"100150","15","15","14","1","9","2.80"
"100153","14","14","13","1","9","2.80"
"100195","9","9","8","1","6","2.80"
"100376","12","12","12","0","7","2.80"
"100516","12","12","10","2","8","2.80"
"100534","11","11","10","1","6","2.80"
"100607","15","15","14","1","10","2.80"
"100641","11","11","11","0","5","2.80"
"101532","16","16","12","4","8","2.80"
"101568","12","12","12","0","8","2.80"
"101623","14","14","13","1","7","2.80"
"101739","14","14","13","1","5","2.80"
"101798","18","18","18","0","15","2.80"
"101854","11","11","10","1","7","2.80"
"101960","7","7","7","0","6","2.80"
"101998","13","13","10","3","7","2.80"
"102227","18","18","18","0","16","2.80"
"102234","15","15","13","2","9","2.80"
"102262","11","11","10","1","6","2.80"
"102371","12","12","9","3","6","2.80"
"102449","10","10","10","0","7","2.80"
"102567","13","13","11","2","8","2.80"
"102618","12","12","11","1","8","2.80"
"102921","14","14","12","2","7","2.80"
"103118","10","10","9","1","7","2.80"
"103166","7","7","7","0","5","2.80"
"103771","11","11","11","0","7","2.80"
"103930","16","16","14","2","9","2.80"
"103976","16","16","13","3","10","2.80"
"103996","8","8","8","0","6","2.80"
"104043","16","16","16","0","11","2.80"
"104064","17","17","15","2","9","2.80"
"104123","13","13","11","2","8","2.80"
"104312","11","11","11","0","6","2.80"
"104364","16","16","15","1","12","2.80"
"104551","11","11","11","0","6","2.80"
"104620","21","21","18","3","13","2.80"
"104875","17","17","14","3","7","2.80"
"105045","10","10","9","1","8","2.80"
"105054","12","12","9","3","5","2.80"
"105124","11","11","10","1","6","2.80"
"105170","15","15","14","1","8","2.80"
"105277","15","15","13","2","5","2.80"
"105411","12","12","11","1","8","2.80"
"105623","13","13","10","3","7","2.80"
"105855","18","18","17","1","10","2.80"
"106044","9","9","9","0","6","2.80"
"106097","12","12","10","2","5","2.80"
"106449","8","8","8","0","7","2.80"
"106501","17","17","16","1","7","2.80"
"106533","11","11","9","2","6","2.80"
"106547","9","9","9","0","5","2.80"
"106569","13","13","12","1","9","2.80"
"106573","11","11","11","0","6","2.80"
"106654","15","15","15","0","6","2.80"
"106787","13","13","11","2","5","2.80"
"106859","9","9","7","2","5","2.80"
"106933","10","10","10","0","6","2.80"
"106984","15","15","15","0","12","2.80"
"107217","14","14","13","1","10","2.80"
"107329","15","15","12","3","9","2.80"
"107365","10","10","9","1","7","2.80"
"107435","11","11","9","2","7","2.80"
"107460","9","9","9","0","5","2.80"
"107466","10","10","8","2","6","2.80"
"107488","9","9","9","0","6","2.80"
"107532","11","11","10","1","5","2.80"
"107669","11","11","10","1","6","2.80"
"107723","12","12","10","2","7","2.80"
"107818","17","17","15","2","11","2.80"
"107837","11","11","9","2","6","2.80"
"107841","15","15","12","3","9","2.80"
"107954","11","11","10","1","7","2.80"
"108126","12","12","10","2","6","2.80"
"108378","13","13","11","2","7","2.80"
"108552","10","10","7","3","5","2.80"
"108572","10","9","10","0","9","2.80"
"108607","12","12","11","1","6","2.80"
"108705","14","14","13","1","9","2.80"
"108872","13","13","10","3","7","2.80"
"109047","23","23","20","3","19","2.80"
"109068","10","10","8","2","6","2.80"
"109077","11","11","10","1","6","2.80"
"109093","18","18","16","2","10","2.80"
"109244","10","10","10","0","6","2.80"
"109304","10","10","10","0","8","2.80"
"109346","13","13","12","1","7","2.80"
"109652","13","13","12","1","9","2.80"
"109805","12","12","11","1","6","2.80"
"109814","8","8","8","0","5","2.80"
"109936","18","18","13","5","10","2.80"
"110022","15","15","13","2","9","2.80"
"110060","16","16","16","0","11","2.80"
"110109","12","12","11","1","5","2.80"
"110123","9","9","9","0","5","2.80"
"110262","11","11","10","1","8","2.80"
"110266","14","14","13","1","11","2.80"
"110339","15","15","11","4","6","2.80"
"110521","11","11","10","1","6","2.80"
"110568","11","11","8","3","6","2.80"
"110645","9","9","8","1","6","2.80"
"110660","12","12","12","0","5","2.80"
"110686","11","11","7","4","6","2.80"
"110688","11","11","10","1","6","2.80"
"110832","14","14","13","1","7","2.80"
"110833","13","13","13","0","6","2.80"
"111013","14","14","11","3","6","2.80"
"111019","16","16","15","1","12","2.80"
"111194","9","9","7","2","5","2.80"
"111247","14","14","12","2","8","2.80"
"111264","9","9","8","1","6","2.80"
"111376","15","15","12","3","7","2.80"
"111607","15","15","14","1","8","2.80"
"111623","10","10","9","1","5","2.80"
"111718","8","8","6","2","6","2.80"
"111761","13","13","12","1","7","2.80"
"111872","16","16","10","6","6","2.80"
"111986","14","14","12","2","7","2.80"
"112001","12","12","12","0","7","2.80"
"112151","9","9","9","0","7","2.80"
"112255","8","8","7","1","5","2.80"
"112262","11","11","11","0","6","2.80"
"112300","10","10","10","0","6","2.80"
"112365","11","11","8","3","6","2.80"
"112379","15","15","12","3","8","2.80"
"112509","13","13","13","0","9","2.80"
"112637","10","10","9","1","5","2.80"
"112873","12","12","10","2","6","2.80"
"113030","11","11","9","2","6","2.80"
"113239","12","12","11","1","7","2.80"
"113306","12","12","10","2","7","2.80"
"113540","24","24","21","3","12","2.80"
"113628","17","17","15","2","9","2.80"
"113629","16","16","13","3","6","2.80"
"113792","17","17","14","3","9","2.80"
"113801","13","13","11","2","8","2.80"
"113816","10","10","10","0","7","2.80"
"113833","10","10","10","0","8","2.80"
"113932","16","16","13","3","7","2.80"
"113949","7","7","7","0","5","2.80"
"114153","15","15","14","1","8","2.80"
"114172","9","9","9","0","7","2.80"
"114270","16","16","14","2","8","2.80"
"114375","11","11","9","2","5","2.80"
"114422","10","10","9","1","5","2.80"
"114426","10","10","7","3","5","2.80"
"114430","15","15","12","3","8","2.80"
"114651","12","12","11","1","7","2.80"
"114859","14","14","13","1","7","2.80"
"114902","14","14","13","1","9","2.80"
"114910","10","10","10","0","5","2.80"
"115014","9","9","8","1","8","2.80"
"115074","18","18","16","2","9","2.80"
"115162","12","12","11","1","7","2.80"
"115246","15","14","14","1","5","2.80"
"115304","9","9","8","1","8","2.80"
"115469","20","20","19","1","15","2.80"
"115510","14","14","14","0","5","2.80"
"115566","11","11","10","1","9","2.80"
"115570","8","8","7","1","5","2.80"
"115910","13","13","13","0","8","2.80"
"115924","15","15","13","2","9","2.80"
"116145","13","13","12","1","9","2.80"
"116271","9","9","8","1","6","2.80"
"116424","18","18","17","1","15","2.80"
"116574","17","17","15","2","11","2.80"
"116980","9","9","7","2","7","2.80"
"117054","8","8","7","1","5","2.80"
"117104","16","16","14","2","10","2.80"
"117133","6","6","6","0","5","2.80"
"117158","18","18","13","5","7","2.80"
"117301","13","13","12","1","6","2.80"
"117374","20","20","16","4","13","2.80"
"117544","12","12","12","0","8","2.80"
"100220","13","13","13","0","9","2.79"
"100274","10","10","10","0","7","2.79"
"100336","20","20","17","3","11","2.79"
"100531","15","15","13","2","9","2.79"
"100549","14","14","14","0","8","2.79"
"100577","16","16","14","2","10","2.79"
"100617","10","10","10","0","9","2.79"
"100667","14","14","13","1","9","2.79"
"100684","14","14","13","1","10","2.79"
"100776","13","13","13","0","10","2.79"
"101044","15","15","15","0","13","2.79"
"101094","12","12","11","1","8","2.79"
"101158","12","12","12","0","9","2.79"
"101384","16","16","15","1","9","2.79"
"101462","17","17","16","1","10","2.79"
"101652","14","14","13","1","9","2.79"
"102141","12","12","11","1","10","2.79"
"102705","16","16","14","2","12","2.79"
"102784","18","18","17","1","12","2.79"
"102810","14","14","12","2","9","2.79"
"102844","9","9","9","0","8","2.79"
"102985","18","18","16","2","11","2.79"
"103034","16","16","14","2","12","2.79"
"103437","21","21","19","2","15","2.79"
"103621","13","13","11","2","8","2.79"
"103889","12","12","12","0","10","2.79"
"103984","14","14","13","1","9","2.79"
"104569","14","14","12","2","9","2.79"
"104636","13","13","12","1","10","2.79"
"104782","12","12","11","1","10","2.79"
"105019","15","15","13","2","8","2.79"
"105072","14","14","14","0","11","2.79"
"105237","17","17","16","1","10","2.79"
"105240","11","11","10","1","8","2.79"
"105285","22","22","20","2","17","2.79"
"105368","15","15","14","1","10","2.79"
"105396","15","15","14","1","11","2.79"
"105693","17","17","15","2","11","2.79"
"105696","14","14","14","0","9","2.79"
"105735","13","13","11","2","7","2.79"
"105751","16","16","15","1","8","2.79"
"105821","13","13","9","4","8","2.79"
"105887","20","20","19","1","14","2.79"
"106105","13","13","12","1","11","2.79"
"106116","11","11","11","0","9","2.79"
"106328","15","15","14","1","12","2.79"
"106369","14","14","13","1","9","2.79"
"106445","18","18","17","1","12","2.79"
"106472","11","11","10","1","10","2.79"
"106692","15","15","12","3","8","2.79"
"106702","21","21","21","0","11","2.79"
"106988","12","12","11","1","9","2.79"
"107079","21","21","19","2","18","2.79"
"107113","10","10","10","0","9","2.79"
"107224","14","14","13","1","7","2.79"
"107283","25","25","23","2","14","2.79"
"107351","16","16","15","1","8","2.79"
"107431","17","17","16","1","10","2.79"
"107947","15","15","14","1","11","2.79"
"108229","15","15","14","1","9","2.79"
"108354","11","11","11","0","11","2.79"
"108357","17","17","16","1","13","2.79"
"108379","12","12","12","0","9","2.79"
"108689","12","12","11","1","8","2.79"
"108901","16","16","15","1","10","2.79"
"108914","25","25","21","4","12","2.79"
"108926","11","11","11","0","9","2.79"
"109096","20","20","19","1","16","2.79"
"109248","19","19","18","1","13","2.79"
"109329","17","17","13","4","8","2.79"
"109511","20","20","18","2","14","2.79"
"109568","14","14","13","1","8","2.79"
"109574","17","17","16","1","9","2.79"
"109591","12","12","11","1","9","2.79"
"109800","15","15","14","1","11","2.79"
"109935","18","18","17","1","11","2.79"
"110327","23","23","21","2","11","2.79"
"110470","16","16","16","0","12","2.79"
"110657","19","19","18","1","14","2.79"
"111032","13","13","13","0","8","2.79"
"111077","17","17","16","1","11","2.79"
"111202","15","15","12","3","8","2.79"
"111430","14","14","12","2","8","2.79"
"111587","15","14","14","1","9","2.79"
"111648","14","14","12","2","8","2.79"
"112034","12","12","11","1","8","2.79"
"112158","10","10","10","0","9","2.79"
"112194","12","11","11","1","10","2.79"
"112315","14","14","11","3","8","2.79"
"112506","13","13","12","1","9","2.79"
"112626","18","18","16","2","12","2.79"
"112757","16","16","13","3","9","2.79"
"112882","11","11","11","0","7","2.79"
"113007","16","16","14","2","8","2.79"
"113037","23","22","21","2","16","2.79"
"113180","18","18","14","4","10","2.79"
"113411","18","18","17","1","12","2.79"
"113568","18","18","16","2","9","2.79"
"113627","15","15","15","0","10","2.79"
"113999","13","13","12","1","10","2.79"
"114785","14","14","13","1","10","2.79"
"114937","17","17","16","1","10","2.79"
"115124","14","14","11","3","8","2.79"
"115217","16","16","16","0","10","2.79"
"115273","18","18","16","2","11","2.79"
"115298","12","12","10","2","8","2.79"
"115480","15","15","13","2","10","2.79"
"115638","17","17","15","2","10","2.79"
"115660","12","12","11","1","10","2.79"
"115673","11","11","10","1","8","2.79"
"115675","11","11","10","1","7","2.79"
"115676","25","24","21","4","11","2.79"
"115716","22","22","20","2","13","2.79"
"115773","16","16","14","2","11","2.79"
"115812","20","20","18","2","14","2.79"
"116107","13","13","12","1","11","2.79"
"116269","12","12","11","1","9","2.79"
"116670","18","18","17","1","11","2.79"
"116960","16","16","14","2","10","2.79"
"117198","14","14","14","0","11","2.79"
"117378","19","19","17","2","9","2.79"
"100302","16","16","16","0","11","2.78"
"100369","12","12","9","3","7","2.78"
"100393","15","15","15","0","10","2.78"
"101196","12","12","12","0","9","2.78"
"101282","11","11","11","0","10","2.78"
"101580","8","8","7","1","5","2.78"
"102338","25","25","18","7","13","2.78"
"102503","20","20","19","1","17","2.78"
"102654","23","23","19","4","15","2.78"
"102920","23","23","21","2","15","2.78"
"102935","21","21","17","4","16","2.78"
"103149","16","15","14","2","9","2.78"
"103570","20","20","16","4","11","2.78"
"103674","16","16","15","1","11","2.78"
"103714","11","11","10","1","5","2.78"
"103851","12","12","12","0","9","2.78"
"104757","13","13","11","2","6","2.78"
"104803","23","23","20","3","16","2.78"
"105336","12","12","10","2","9","2.78"
"105993","22","22","21","1","15","2.78"
"106005","13","13","11","2","9","2.78"
"106499","20","20","17","3","13","2.78"
"106733","10","10","9","1","9","2.78"
"106882","15","15","14","1","10","2.78"
"106976","12","12","11","1","8","2.78"
"107090","16","16","15","1","12","2.78"
"107195","17","17","16","1","13","2.78"
"107208","19","19","17","2","10","2.78"
"107486","13","13","11","2","9","2.78"
"107884","14","14","9","5","8","2.78"
"107927","14","14","12","2","9","2.78"
"107938","20","20","18","2","13","2.78"
"108073","11","11","10","1","6","2.78"
"108083","14","14","12","2","10","2.78"
"108202","14","14","12","2","11","2.78"
"108998","12","12","11","1","8","2.78"
"109130","12","12","9","3","8","2.78"
"109306","14","14","13","1","10","2.78"
"109466","16","16","14","2","8","2.78"
"109663","21","21","19","2","16","2.78"
"109723","17","17","13","4","10","2.78"
"109750","13","13","12","1","7","2.78"
"109820","11","11","8","3","5","2.78"
"109927","16","16","16","0","12","2.78"
"110546","23","23","18","5","11","2.78"
"110602","21","21","19","2","15","2.78"
"111322","21","21","21","0","15","2.78"
"112176","20","20","17","3","14","2.78"
"112715","15","15","14","1","9","2.78"
"112775","19","19","17","2","15","2.78"
"112943","14","14","12","2","9","2.78"
"113289","12","12","12","0","9","2.78"
"113494","12","12","12","0","7","2.78"
"113606","15","15","14","1","10","2.78"
"114142","16","16","14","2","10","2.78"
"114605","15","15","14","1","11","2.78"
"114929","13","13","12","1","5","2.78"
"114932","14","14","13","1","10","2.78"
"115049","20","20","20","0","16","2.78"
"115067","12","12","11","1","9","2.78"
"115079","24","24","23","1","15","2.78"
"115086","15","15","10","5","8","2.78"
"115131","26","26","23","3","16","2.78"
"115882","12","12","11","1","8","2.78"
"116157","21","21","19","2","13","2.78"
"116374","14","14","13","1","9","2.78"
"116688","12","12","12","0","11","2.78"
"116844","19","19","17","2","15","2.78"
"116863","21","21","19","2","14","2.78"
"117526","19","19","18","1","12","2.78"
"100157","22","22","21","1","16","2.77"
"101363","15","15","11","4","10","2.77"
"101839","21","20","19","2","14","2.77"
"102115","14","14","12","2","9","2.77"
"102335","21","21","21","0","18","2.77"
"102369","17","17","16","1","15","2.77"
"103336","16","16","13","3","8","2.77"
"104924","13","13","12","1","8","2.77"
"105477","16","16","15","1","13","2.77"
"105793","14","14","12","2","10","2.77"
"105950","14","14","13","1","9","2.77"
"106091","18","18","18","0","14","2.77"
"106204","16","16","14","2","11","2.77"
"106840","15","15","12","3","8","2.77"
"108256","17","17","17","0","9","2.77"
"108858","18","18","16","2","14","2.77"
"109803","17","17","15","2","9","2.77"
"110191","13","13","12","1","8","2.77"
"110228","15","15","14","1","10","2.77"
"110676","14","14","14","0","12","2.77"
"111279","15","15","13","2","9","2.77"
"111475","16","16","12","4","9","2.77"
"111594","24","24","23","1","16","2.77"
"111652","18","18","16","2","13","2.77"
"111655","10","10","9","1","8","2.77"
"111975","11","11","11","0","9","2.77"
"112222","12","12","11","1","9","2.77"
"112382","14","14","11","3","8","2.77"
"112529","11","11","9","2","8","2.77"
"112580","15","15","15","0","10","2.77"
"112587","16","16","14","2","11","2.77"
"112813","10","10","9","1","8","2.77"
"113023","13","13","13","0","10","2.77"
"113365","14","14","10","4","8","2.77"
"113590","10","10","10","0","10","2.77"
"113712","15","15","15","0","12","2.77"
"114128","20","20","17","3","12","2.77"
"114162","15","15","14","1","11","2.77"
"114649","20","20","18","2","12","2.77"
"115268","15","15","15","0","11","2.77"
"115928","16","16","15","1","14","2.77"
"116184","17","17","15","2","12","2.77"
"116580","23","23","22","1","15","2.77"
"117524","16","16","14","2","12","2.77"
"100045","20","20","19","1","16","2.76"
"100325","14","14","13","1","9","2.76"
"100410","20","20","18","2","17","2.76"
"100479","16","16","16","0","11","2.76"
"100682","19","19","18","1","11","2.76"
"100950","10","10","10","0","10","2.76"
"100996","18","18","17","1","12","2.76"
"101147","17","17","16","1","12","2.76"
"101446","12","12","12","0","11","2.76"
"101453","22","22","20","2","13","2.76"
"101955","17","17","16","1","12","2.76"
"102077","15","15","14","1","12","2.76"
"102176","17","17","17","0","12","2.76"
"102219","13","13","12","1","9","2.76"
"102292","16","16","16","0","16","2.76"
"102803","17","17","15","2","11","2.76"
"103010","20","20","18","2","9","2.76"
"103375","15","15","14","1","10","2.76"
"103679","16","16","14","2","11","2.76"
"104253","19","19","17","2","12","2.76"
"104293","13","13","13","0","11","2.76"
"104926","15","15","13","2","9","2.76"
"104973","11","11","11","0","10","2.76"
"105117","12","12","12","0","10","2.76"
"105295","16","16","15","1","10","2.76"
"105495","11","11","10","1","9","2.76"
"105682","15","15","15","0","13","2.76"
"105818","20","20","18","2","15","2.76"
"107231","25","25","20","5","15","2.76"
"107401","22","22","21","1","14","2.76"
"107719","17","17","17","0","12","2.76"
"107726","25","25","24","1","17","2.76"
"108325","13","13","11","2","10","2.76"
"108935","21","21","19","2","16","2.76"
"108959","11","11","11","0","9","2.76"
"110417","11","11","10","1","10","2.76"
"110524","17","17","17","0","12","2.76"
"110605","17","17","14","3","11","2.76"
"110924","19","19","16","3","13","2.76"
"111339","16","16","14","2","11","2.76"
"111560","16","16","15","1","11","2.76"
"112183","12","12","12","0","9","2.76"
"112668","16","16","15","1","13","2.76"
"113561","18","18","17","1","13","2.76"
"113787","19","19","19","0","13","2.76"
"116315","18","18","17","1","11","2.76"
"116395","14","14","13","1","11","2.76"
"116704","11","11","11","0","9","2.76"
"116802","16","16","15","1","9","2.76"
"116899","19","19","18","1","13","2.76"
"117260","15","15","14","1","9","2.76"
"117550","18","18","14","4","11","2.76"
"100019","13","13","13","0","11","2.75"
"100134","13","13","10","3","8","2.75"
"100428","12","12","11","1","9","2.75"
"100482","15","15","13","2","11","2.75"
"100564","15","15","14","1","10","2.75"
"100688","17","17","13","4","11","2.75"
"100710","16","16","14","2","11","2.75"
"100737","15","15","12","3","7","2.75"
"100739","16","16","15","1","11","2.75"
"100969","17","17","16","1","11","2.75"
"100993","15","15","13","2","8","2.75"
"101051","14","14","14","0","10","2.75"
"101130","13","13","13","0","8","2.75"
"101161","9","9","9","0","8","2.75"
"101324","18","18","16","2","10","2.75"
"101514","14","14","12","2","9","2.75"
"101545","12","12","10","2","7","2.75"
"101674","8","8","8","0","7","2.75"
"101688","8","8","8","0","4","2.75"
"101763","17","17","12","5","8","2.75"
"101806","18","18","18","0","11","2.75"
"101842","9","9","9","0","5","2.75"
"102116","15","15","12","3","10","2.75"
"102187","15","15","13","2","6","2.75"
"102191","7","7","7","0","6","2.75"
"102379","7","7","5","2","4","2.75"
"102516","20","20","16","4","12","2.75"
"102530","18","18","15","3","12","2.75"
"102533","15","15","12","3","7","2.75"
"102562","11","11","10","1","5","2.75"
"102872","6","6","5","1","4","2.75"
"102886","12","12","10","2","10","2.75"
"102901","11","11","10","1","7","2.75"
"103027","18","18","16","2","10","2.75"
"103055","11","11","10","1","4","2.75"
"103088","10","10","9","1","8","2.75"
"103228","19","19","17","2","10","2.75"
"103237","9","8","9","0","8","2.75"
"103289","16","16","13","3","7","2.75"
"103322","13","13","12","1","9","2.75"
"103438","20","20","18","2","10","2.75"
"103495","18","18","17","1","12","2.75"
"103539","15","15","14","1","10","2.75"
"103542","22","22","21","1","17","2.75"
"103558","18","18","17","1","10","2.75"
"103699","12","12","7","5","7","2.75"
"103723","14","14","13","1","9","2.75"
"103745","16","16","14","2","8","2.75"
"103761","13","13","12","1","7","2.75"
"103791","15","15","15","0","14","2.75"
"103929","11","11","10","1","8","2.75"
"103947","12","12","10","2","8","2.75"
"103957","12","11","10","2","9","2.75"
"104009","14","14","13","1","9","2.75"
"104118","7","7","7","0","6","2.75"
"104122","8","8","6","2","4","2.75"
"104283","15","15","13","2","10","2.75"
"104435","10","10","8","2","6","2.75"
"104485","12","12","10","2","7","2.75"
"104545","7","7","6","1","4","2.75"
"104622","11","11","9","2","4","2.75"
"104682","13","13","12","1","9","2.75"
"104753","12","12","10","2","10","2.75"
"104778","14","14","13","1","8","2.75"
"104830","16","16","15","1","13","2.75"
"104836","16","16","16","0","11","2.75"
"104853","9","9","9","0","4","2.75"
"104898","8","8","6","2","3","2.75"
"104913","12","12","8","4","6","2.75"
"105028","11","11","11","0","8","2.75"
"105048","6","6","6","0","3","2.75"
"105086","16","16","13","3","7","2.75"
"105175","14","14","13","1","11","2.75"
"105184","15","14","12","3","7","2.75"
"105260","11","11","10","1","8","2.75"
"105262","9","9","9","0","7","2.75"
"105310","12","12","11","1","8","2.75"
"105339","8","8","8","0","5","2.75"
"105352","14","14","12","2","10","2.75"
"105362","11","11","11","0","9","2.75"
"105421","15","15","15","0","11","2.75"
"105441","22","22","18","4","14","2.75"
"105456","15","15","13","2","8","2.75"
"105470","13","13","11","2","9","2.75"
"105485","14","14","12","2","7","2.75"
"105629","9","9","6","3","4","2.75"
"105684","14","14","13","1","8","2.75"
"105720","11","11","9","2","8","2.75"
"105755","17","17","15","2","9","2.75"
"105764","15","15","14","1","10","2.75"
"105808","11","11","10","1","5","2.75"
"105859","10","10","9","1","8","2.75"
"105886","18","18","14","4","12","2.75"
"105901","13","13","10","3","9","2.75"
"105949","7","7","6","1","4","2.75"
"106012","11","11","10","1","6","2.75"
"106043","15","15","14","1","12","2.75"
"106071","12","12","11","1","8","2.75"
"106130","16","16","14","2","8","2.75"
"106168","14","14","12","2","8","2.75"
"106280","12","12","12","0","8","2.75"
"106346","11","11","9","2","5","2.75"
"106484","19","19","19","0","12","2.75"
"106565","13","13","12","1","6","2.75"
"106634","14","14","11","3","8","2.75"
"106849","17","17","14","3","9","2.75"
"106854","15","15","14","1","9","2.75"
"106870","10","10","8","2","7","2.75"
"106903","8","8","8","0","5","2.75"
"106994","9","9","8","1","4","2.75"
"107056","7","7","7","0","5","2.75"
"107061","7","7","7","0","4","2.75"
"107072","15","15","13","2","7","2.75"
"107140","20","20","15","5","11","2.75"
"107189","5","5","5","0","4","2.75"
"107226","7","7","7","0","6","2.75"
"107237","25","24","23","2","17","2.75"
"107314","20","20","20","0","18","2.75"
"107355","8","8","7","1","5","2.75"
"107358","16","16","14","2","9","2.75"
"107456","7","7","7","0","4","2.75"
"107481","8","8","8","0","5","2.75"
"107642","9","9","8","1","6","2.75"
"107678","11","11","10","1","6","2.75"
"107822","14","14","11","3","7","2.75"
"107835","7","7","7","0","4","2.75"
"107863","11","11","9","2","4","2.75"
"107913","17","17","13","4","11","2.75"
"108007","16","16","15","1","5","2.75"
"108061","17","17","15","2","11","2.75"
"108138","14","14","12","2","9","2.75"
"108157","15","15","13","2","11","2.75"
"108189","10","10","9","1","7","2.75"
"108283","14","14","8","6","7","2.75"
"108331","21","21","15","6","9","2.75"
"108358","10","10","10","0","9","2.75"
"108443","7","7","7","0","5","2.75"
"108599","16","16","13","3","7","2.75"
"108627","13","13","12","1","10","2.75"
"108676","9","9","8","1","4","2.75"
"108777","16","16","14","2","10","2.75"
"108784","12","12","10","2","8","2.75"
"108823","8","8","8","0","6","2.75"
"108825","6","6","6","0","4","2.75"
"108882","15","15","14","1","10","2.75"
"109017","9","9","8","1","4","2.75"
"109051","21","21","19","2","13","2.75"
"109060","10","10","9","1","5","2.75"
"109099","15","15","14","1","8","2.75"
"109174","13","13","10","3","8","2.75"
"109236","18","18","16","2","13","2.75"
"109328","11","11","10","1","4","2.75"
"109373","9","9","8","1","3","2.75"
"109408","14","14","12","2","8","2.75"
"109418","17","17","16","1","12","2.75"
"109661","17","17","13","4","8","2.75"
"109683","11","11","8","3","4","2.75"
"109742","17","17","16","1","10","2.75"
"109890","10","10","7","3","4","2.75"
"109905","16","16","14","2","10","2.75"
"110014","7","7","7","0","4","2.75"
"110062","16","16","16","0","10","2.75"
"110145","10","10","10","0","8","2.75"
"110218","13","13","10","3","5","2.75"
"110418","13","13","10","3","6","2.75"
"110488","17","17","13","4","10","2.75"
"110502","15","15","13","2","11","2.75"
"110579","13","13","10","3","8","2.75"
"110655","16","16","13","3","6","2.75"
"110704","12","12","11","1","7","2.75"
"110870","12","12","12","0","9","2.75"
"110967","8","8","6","2","5","2.75"
"110981","16","16","11","5","8","2.75"
"111002","12","12","10","2","4","2.75"
"111133","15","15","12","3","9","2.75"
"111191","19","19","16","3","11","2.75"
"111209","16","16","14","2","11","2.75"
"111298","15","15","11","4","7","2.75"
"111311","17","17","15","2","4","2.75"
"111508","14","14","13","1","10","2.75"
"111521","12","12","11","1","7","2.75"
"111581","16","16","15","1","7","2.75"
"111589","7","7","7","0","4","2.75"
"111642","8","8","7","1","4","2.75"
"111862","18","18","17","1","13","2.75"
"111936","11","11","10","1","6","2.75"
"111956","8","8","6","2","5","2.75"
"112186","14","14","13","1","8","2.75"
"112319","7","7","6","1","5","2.75"
"112327","13","13","12","1","10","2.75"
"112386","16","16","14","2","11","2.75"
"112388","12","12","10","2","9","2.75"
"112418","16","16","14","2","7","2.75"
"112470","12","12","12","0","9","2.75"
"112479","15","15","13","2","10","2.75"
"112732","11","11","11","0","8","2.75"
"112774","15","15","14","1","10","2.75"
"112779","10","10","10","0","8","2.75"
"112929","10","10","8","2","4","2.75"
"112999","13","13","11","2","8","2.75"
"113139","8","8","7","1","4","2.75"
"113166","17","17","17","0","13","2.75"
"113202","12","12","10","2","5","2.75"
"113205","8","8","7","1","4","2.75"
"113225","17","17","16","1","10","2.75"
"113228","12","12","10","2","8","2.75"
"113309","11","11","11","0","9","2.75"
"113364","10","10","10","0","9","2.75"
"113396","16","16","14","2","8","2.75"
"113490","12","12","10","2","4","2.75"
"113531","20","20","17","3","13","2.75"
"113710","6","6","6","0","6","2.75"
"113732","11","11","10","1","7","2.75"
"113863","16","16","16","0","9","2.75"
"113969","16","16","16","0","11","2.75"
"113978","13","13","12","1","6","2.75"
"114061","10","10","10","0","4","2.75"
"114069","11","11","10","1","7","2.75"
"114078","15","15","13","2","8","2.75"
"114146","15","15","13","2","7","2.75"
"114175","10","10","8","2","5","2.75"
"114213","13","13","13","0","5","2.75"
"114217","16","16","12","4","9","2.75"
"114335","19","19","17","2","12","2.75"
"114423","21","21","19","2","13","2.75"
"114487","11","11","11","0","8","2.75"
"114535","14","14","13","1","8","2.75"
"114694","9","9","7","2","6","2.75"
"114750","8","8","8","0","5","2.75"
"114998","13","13","11","2","9","2.75"
"115008","14","14","14","0","8","2.75"
"115028","8","8","7","1","5","2.75"
"115101","13","13","10","3","7","2.75"
"115114","11","11","10","1","7","2.75"
"115244","13","13","10","3","8","2.75"
"115360","16","16","16","0","13","2.75"
"115383","7","7","7","0","5","2.75"
"115460","10","10","10","0","6","2.75"
"115518","10","10","10","0","4","2.75"
"115545","14","14","11","3","8","2.75"
"115702","9","9","8","1","6","2.75"
"115727","16","16","14","2","8","2.75"
"115779","13","13","13","0","11","2.75"
"115805","9","9","9","0","6","2.75"
"115816","14","14","12","2","9","2.75"
"115946","16","16","14","2","11","2.75"
"115954","9","9","8","1","6","2.75"
"115979","13","13","11","2","8","2.75"
"115985","10","10","9","1","6","2.75"
"116129","16","16","16","0","12","2.75"
"116135","12","12","11","1","8","2.75"
"116293","13","13","12","1","4","2.75"
"116296","13","13","11","2","8","2.75"
"116397","12","12","12","0","4","2.75"
"116403","5","5","5","0","4","2.75"
"116443","13","13","13","0","11","2.75"
"116467","7","7","6","1","4","2.75"
"116523","17","17","17","0","11","2.75"
"116604","9","9","7","2","5","2.75"
"116625","12","12","11","1","7","2.75"
"116648","15","15","13","2","8","2.75"
"116656","21","21","20","1","15","2.75"
"116797","9","9","7","2","3","2.75"
"116837","13","13","12","1","9","2.75"
"116933","12","12","9","3","5","2.75"
"117023","6","6","5","1","4","2.75"
"117110","16","16","15","1","11","2.75"
"117114","8","8","8","0","4","2.75"
"117191","16","16","16","0","10","2.75"
"117193","15","15","13","2","10","2.75"
"117205","17","17","17","0","7","2.75"
"117257","9","9","9","0","8","2.75"
"117262","16","16","13","3","8","2.75"
"117297","15","15","15","0","11","2.75"
"117317","5","5","5","0","5","2.75"
"117330","23","23","22","1","12","2.75"
"117347","11","11","10","1","7","2.75"
"117382","15","15","13","2","9","2.75"
"117410","19","19","16","3","13","2.75"
"117453","21","21","17","4","14","2.75"
"117467","13","13","13","0","9","2.75"
"117532","16","16","15","1","11","2.75"
"100129","12","11","12","0","12","2.74"
"100141","18","18","16","2","11","2.74"
"100293","15","15","15","0","12","2.74"
"100388","19","19","18","1","14","2.74"
"101927","22","22","19","3","14","2.74"
"102471","17","17","14","3","13","2.74"
"102923","18","18","17","1","11","2.74"
"103048","16","16","14","2","11","2.74"
"103253","15","15","14","1","12","2.74"
"104222","19","19","17","2","10","2.74"
"104250","24","24","23","1","19","2.74"
"104274","20","20","15","5","11","2.74"
"107084","15","15","15","0","12","2.74"
"107876","17","17","15","2","11","2.74"
"108078","21","21","20","1","15","2.74"
"108082","13","13","12","1","11","2.74"
"108304","16","16","14","2","12","2.74"
"109197","22","22","19","3","15","2.74"
"109552","20","20","18","2","14","2.74"
"109853","26","26","24","2","16","2.74"
"110063","14","14","11","3","10","2.74"
"110310","24","24","21","3","13","2.74"
"110786","17","17","17","0","13","2.74"
"111561","18","18","17","1","10","2.74"
"112101","15","15","15","0","11","2.74"
"113122","19","19","16","3","14","2.74"
"114456","17","17","16","1","11","2.74"
"115163","17","17","14","3","12","2.74"
"115537","19","19","18","1","11","2.74"
"116304","22","22","21","1","13","2.74"
"116365","17","17","17","0","15","2.74"
"117075","18","18","14","4","12","2.74"
"101063","11","11","10","1","9","2.73"
"101757","9","9","9","0","8","2.73"
"103137","16","16","16","0","13","2.73"
"103190","19","19","17","2","11","2.73"
"103196","12","12","12","0","7","2.73"
"103548","12","12","12","0","9","2.73"
"103631","19","19","17","2","14","2.73"
"103862","12","12","11","1","8","2.73"
"103992","14","14","14","0","7","2.73"
"104134","12","12","11","1","7","2.73"
"104865","15","15","14","1","12","2.73"
"104897","20","20","19","1","10","2.73"
"104969","17","17","16","1","10","2.73"
"105371","8","8","8","0","7","2.73"
"105953","15","15","14","1","8","2.73"
"106084","12","12","10","2","9","2.73"
"106139","13","13","11","2","8","2.73"
"106241","12","12","11","1","8","2.73"
"106862","11","11","10","1","8","2.73"
"107534","18","18","18","0","14","2.73"
"107655","18","18","17","1","14","2.73"
"108197","16","16","14","2","8","2.73"
"108280","21","21","19","2","16","2.73"
"108470","13","13","12","1","7","2.73"
"108498","16","16","13","3","8","2.73"
"109132","14","14","13","1","11","2.73"
"109365","15","15","14","1","9","2.73"
"109386","14","14","13","1","7","2.73"
"110036","17","17","14","3","12","2.73"
"110066","12","12","11","1","7","2.73"
"110085","12","12","11","1","8","2.73"
"110386","15","15","15","0","12","2.73"
"110556","12","12","11","1","7","2.73"
"110746","15","15","14","1","11","2.73"
"110895","9","9","9","0","8","2.73"
"110956","17","17","15","2","9","2.73"
"112377","16","16","14","2","12","2.73"
"113162","19","19","17","2","13","2.73"
"114316","15","15","15","0","12","2.73"
"115320","16","16","13","3","9","2.73"
"115392","14","14","12","2","10","2.73"
"115470","17","17","16","1","13","2.73"
"115525","15","15","15","0","8","2.73"
"115783","8","8","8","0","8","2.73"
"115915","14","14","13","1","7","2.73"
"100307","20","20","17","3","12","2.72"
"100934","19","19","16","3","10","2.72"
"101185","16","16","15","1","13","2.72"
"101223","17","17","15","2","12","2.72"
"101423","14","14","13","1","8","2.72"
"101452","17","17","14","3","10","2.72"
"101470","10","10","10","0","9","2.72"
"101678","13","13","13","0","10","2.72"
"101712","20","20","15","5","13","2.72"
"102030","13","13","12","1","8","2.72"
"102540","11","11","9","2","8","2.72"
"102549","14","14","12","2","10","2.72"
"102936","20","20","16","4","14","2.72"
"103116","17","17","14","3","11","2.72"
"103661","14","14","13","1","10","2.72"
"103817","17","17","15","2","9","2.72"
"104107","18","18","13","5","10","2.72"
"104488","17","17","16","1","12","2.72"
"104579","17","17","17","0","14","2.72"
"104712","14","14","14","0","12","2.72"
"104817","22","22","20","2","14","2.72"
"105039","18","18","17","1","11","2.72"
"105112","13","13","13","0","11","2.72"
"105440","21","21","18","3","10","2.72"
"105766","23","23","20","3","14","2.72"
"105803","17","17","17","0","11","2.72"
"106254","17","17","16","1","13","2.72"
"106628","23","23","21","2","16","2.72"
"106795","18","18","14","4","9","2.72"
"107050","19","19","19","0","13","2.72"
"107200","16","16","13","3","10","2.72"
"107362","12","12","11","1","8","2.72"
"107676","15","15","15","0","11","2.72"
"107703","13","13","10","3","6","2.72"
"109272","9","9","8","1","6","2.72"
"109859","14","14","12","2","10","2.72"
"110122","15","15","14","1","11","2.72"
"110237","16","16","15","1","10","2.72"
"110341","19","19","17","2","12","2.72"
"110694","15","15","14","1","11","2.72"
"110820","15","15","14","1","10","2.72"
"111746","19","19","18","1","10","2.72"
"112220","15","14","14","1","11","2.72"
"112687","18","18","17","1","13","2.72"
"113104","9","9","9","0","8","2.72"
"113430","20","20","19","1","14","2.72"
"114498","14","14","13","1","9","2.72"
"114621","16","16","16","0","9","2.72"
"115150","14","14","14","0","11","2.72"
"115264","18","18","16","2","14","2.72"
"115283","13","13","13","0","9","2.72"
"115488","20","20","17","3","10","2.72"
"115491","22","22","18","4","15","2.72"
"115549","12","12","10","2","9","2.72"
"115611","19","19","16","3","14","2.72"
"115808","19","19","19","0","15","2.72"
"116673","17","17","15","2","13","2.72"
"116803","14","14","14","0","11","2.72"
"116956","19","19","17","2","14","2.72"
"117070","20","20","18","2","9","2.72"
"100034","16","16","14","2","10","2.71"
"100166","13","13","12","1","9","2.71"
"100381","10","10","10","0","9","2.71"
"100399","19","19","17","2","11","2.71"
"100514","14","14","11","3","7","2.71"
"100558","14","14","12","2","8","2.71"
"100690","11","11","10","1","7","2.71"
"100773","19","19","17","2","12","2.71"
"100941","19","19","15","4","13","2.71"
"101054","14","14","14","0","9","2.71"
"101171","12","12","11","1","9","2.71"
"101236","17","17","16","1","10","2.71"
"101493","16","16","13","3","11","2.71"
"101569","17","17","17","0","10","2.71"
"101694","14","14","13","1","11","2.71"
"101795","18","18","17","1","14","2.71"
"101953","14","14","12","2","10","2.71"
"102008","15","15","12","3","7","2.71"
"102101","17","17","15","2","9","2.71"
"102132","12","12","10","2","7","2.71"
"102151","16","16","15","1","10","2.71"
"102271","20","20","18","2","13","2.71"
"102302","13","13","10","3","9","2.71"
"102440","15","15","14","1","11","2.71"
"102467","9","9","7","2","7","2.71"
"102602","15","14","15","0","12","2.71"
"102744","14","14","14","0","9","2.71"
"102948","12","12","12","0","8","2.71"
"103065","11","11","11","0","9","2.71"
"103100","19","19","19","0","13","2.71"
"103240","13","13","11","2","8","2.71"
"103390","12","12","10","2","8","2.71"
"103392","10","10","9","1","9","2.71"
"103413","16","16","15","1","10","2.71"
"103645","9","9","9","0","7","2.71"
"104077","16","16","15","1","10","2.71"
"104090","17","17","16","1","10","2.71"
"104094","19","19","17","2","11","2.71"
"104759","10","10","10","0","8","2.71"
"104789","16","16","14","2","9","2.71"
"105015","16","16","13","3","10","2.71"
"105024","23","23","20","3","14","2.71"
"105267","17","17","14","3","9","2.71"
"105334","14","14","14","0","11","2.71"
"105353","16","16","15","1","12","2.71"
"105367","19","19","16","3","8","2.71"
"105633","14","14","11","3","10","2.71"
"106034","16","16","15","1","9","2.71"
"106307","13","13","12","1","9","2.71"
"106406","15","15","15","0","9","2.71"
"106428","21","21","19","2","11","2.71"
"106655","15","15","14","1","11","2.71"
"107027","14","14","14","0","12","2.71"
"107062","16","16","13","3","9","2.71"
"107133","12","12","12","0","8","2.71"
"107185","14","14","14","0","13","2.71"
"107520","13","13","11","2","8","2.71"
"107627","13","13","11","2","9","2.71"
"107960","10","10","9","1","7","2.71"
"108006","12","12","12","0","10","2.71"
"108300","16","16","14","2","9","2.71"
"108564","15","15","15","0","9","2.71"
"108660","14","14","11","3","9","2.71"
"108723","17","17","16","1","9","2.71"
"108948","12","12","11","1","7","2.71"
"108957","12","12","12","0","9","2.71"
"109035","11","11","10","1","8","2.71"
"109118","13","13","11","2","7","2.71"
"109250","13","13","12","1","8","2.71"
"109468","12","12","11","1","8","2.71"
"109476","16","16","15","1","8","2.71"
"109479","15","15","15","0","10","2.71"
"109495","14","14","13","1","10","2.71"
"109628","12","12","12","0","8","2.71"
"109678","22","22","20","2","12","2.71"
"109790","15","15","15","0","13","2.71"
"109886","15","15","14","1","12","2.71"
"109934","15","15","14","1","12","2.71"
"110129","16","16","13","3","9","2.71"
"110194","22","22","21","1","15","2.71"
"110387","14","14","13","1","9","2.71"
"110406","11","11","11","0","8","2.71"
"110419","19","19","16","3","11","2.71"
"110429","20","20","16","4","9","2.71"
"110498","13","13","13","0","8","2.71"
"110744","19","19","18","1","11","2.71"
"111018","18","18","15","3","11","2.71"
"111041","22","22","20","2","12","2.71"
"111205","17","17","17","0","11","2.71"
"111215","15","15","14","1","8","2.71"
"111261","15","15","14","1","9","2.71"
"111388","15","15","15","0","12","2.71"
"111614","12","12","12","0","9","2.71"
"111868","11","11","11","0","8","2.71"
"111869","15","15","15","0","11","2.71"
"112215","16","16","15","1","8","2.71"
"112344","16","15","15","1","9","2.71"
"112378","15","15","15","0","10","2.71"
"112718","15","15","14","1","12","2.71"
"112980","15","15","14","1","9","2.71"
"112981","15","15","14","1","12","2.71"
"113049","17","17","16","1","11","2.71"
"113354","17","17","16","1","10","2.71"
"113549","10","10","9","1","7","2.71"
"113781","19","19","16","3","8","2.71"
"113893","15","15","15","0","12","2.71"
"113952","15","15","13","2","9","2.71"
"113957","15","15","12","3","12","2.71"
"114026","14","14","14","0","10","2.71"
"114161","24","24","23","1","16","2.71"
"114431","16","16","14","2","10","2.71"
"114528","17","17","16","1","9","2.71"
"114813","11","11","9","2","8","2.71"
"115017","12","12","11","1","10","2.71"
"115213","14","14","13","1","11","2.71"
"115260","18","18","16","2","10","2.71"
"115364","11","11","9","2","8","2.71"
"115578","17","17","15","2","10","2.71"
"115643","18","18","16","2","12","2.71"
"115785","8","8","8","0","7","2.71"
"115823","16","16","15","1","12","2.71"
"116108","20","19","19","1","14","2.71"
"116214","17","17","14","3","11","2.71"
"116459","19","19","19","0","15","2.71"
"116540","12","12","10","2","10","2.71"
"116605","15","15","14","1","9","2.71"
"116939","13","13","12","1","10","2.71"
"116993","10","10","10","0","8","2.71"
"117340","16","16","16","0","8","2.71"
"117435","20","19","17","3","12","2.71"
"117487","12","12","10","2","7","2.71"
"117588","15","15","13","2","7","2.71"
"100025","17","17","16","1","10","2.70"
"100084","14","14","12","2","11","2.70"
"100154","21","21","19","2","10","2.70"
"100206","12","12","12","0","8","2.70"
"100315","12","12","10","2","8","2.70"
"100457","10","10","10","0","7","2.70"
"100469","30","30","26","4","18","2.70"
"100485","14","14","13","1","10","2.70"
"100914","12","12","9","3","8","2.70"
"100970","17","17","14","3","11","2.70"
"101048","8","8","7","1","6","2.70"
"101148","11","11","10","1","6","2.70"
"101294","14","14","14","0","6","2.70"
"101307","13","13","10","3","7","2.70"
"101386","13","13","12","1","7","2.70"
"101418","15","15","14","1","9","2.70"
"101791","18","18","16","2","11","2.70"
"102531","11","11","9","2","6","2.70"
"102660","25","25","23","2","18","2.70"
"102718","19","19","16","3","9","2.70"
"102772","14","14","11","3","7","2.70"
"103008","13","13","8","5","6","2.70"
"103101","13","12","11","2","8","2.70"
"103369","15","15","15","0","6","2.70"
"103417","12","12","10","2","8","2.70"
"103465","19","19","15","4","11","2.70"
"103625","12","12","10","2","7","2.70"
"103642","12","12","12","0","10","2.70"
"103678","21","21","18","3","14","2.70"
"103910","10","10","8","2","6","2.70"
"103962","15","15","14","1","7","2.70"
"103975","20","20","17","3","13","2.70"
"104008","13","13","11","2","9","2.70"
"104131","16","16","15","1","9","2.70"
"104211","13","13","13","0","11","2.70"
"105192","11","11","9","2","7","2.70"
"105361","10","10","8","2","6","2.70"
"105364","11","11","10","1","8","2.70"
"106080","12","12","11","1","6","2.70"
"106106","16","16","16","0","10","2.70"
"106109","14","14","12","2","9","2.70"
"106161","14","14","12","2","9","2.70"
"106410","14","14","10","4","8","2.70"
"106576","14","14","13","1","8","2.70"
"106645","15","15","15","0","10","2.70"
"106814","8","8","7","1","6","2.70"
"106828","13","13","11","2","8","2.70"
"106940","13","13","11","2","8","2.70"
"107021","11","11","10","1","7","2.70"
"107098","15","15","11","4","6","2.70"
"107121","17","17","15","2","11","2.70"
"107209","13","13","12","1","6","2.70"
"107395","16","16","11","5","6","2.70"
"107442","22","22","21","1","16","2.70"
"107582","16","16","15","1","7","2.70"
"107732","16","16","15","1","7","2.70"
"107768","18","18","15","3","7","2.70"
"107803","11","11","10","1","7","2.70"
"107827","10","10","10","0","8","2.70"
"107945","13","13","10","3","7","2.70"
"108292","11","11","11","0","6","2.70"
"108462","16","16","16","0","15","2.70"
"108484","11","11","9","2","7","2.70"
"108654","16","16","14","2","12","2.70"
"108812","9","9","8","1","7","2.70"
"108833","22","22","17","5","7","2.70"
"109293","18","18","17","1","16","2.70"
"109421","13","13","10","3","6","2.70"
"109562","13","13","13","0","9","2.70"
"109679","10","10","9","1","6","2.70"
"109682","10","10","9","1","6","2.70"
"109722","10","10","9","1","7","2.70"
"109860","14","14","14","0","13","2.70"
"110078","16","16","12","4","6","2.70"
"110293","10","10","9","1","8","2.70"
"110401","16","16","15","1","10","2.70"
"110479","15","15","14","1","11","2.70"
"110537","11","11","9","2","6","2.70"
"110565","12","12","12","0","9","2.70"
"110635","9","9","7","2","6","2.70"
"110649","19","19","17","2","13","2.70"
"110803","13","13","11","2","10","2.70"
"110905","11","11","9","2","7","2.70"
"111246","9","9","9","0","6","2.70"
"111331","12","12","11","1","6","2.70"
"111438","11","11","11","0","7","2.70"
"111448","20","20","19","1","14","2.70"
"111483","22","21","20","2","17","2.70"
"111502","10","10","9","1","6","2.70"
"111654","14","14","14","0","6","2.70"
"111656","14","14","12","2","6","2.70"
"111739","12","12","11","1","7","2.70"
"111896","10","10","10","0","7","2.70"
"111913","17","17","14","3","10","2.70"
"111961","17","17","13","4","12","2.70"
"112353","18","18","16","2","13","2.70"
"112406","19","19","17","2","9","2.70"
"112635","19","19","17","2","7","2.70"
"112825","16","16","15","1","8","2.70"
"113099","21","21","18","3","13","2.70"
"113117","18","18","17","1","10","2.70"
"113278","24","23","22","2","17","2.70"
"113293","15","15","14","1","8","2.70"
"113439","15","15","14","1","7","2.70"
"113462","12","11","11","1","6","2.70"
"113580","22","22","22","0","19","2.70"
"113668","15","15","14","1","9","2.70"
"113726","9","9","9","0","7","2.70"
"113733","9","9","9","0","7","2.70"
"113830","12","12","10","2","7","2.70"
"113948","14","14","13","1","7","2.70"
"113962","13","13","11","2","8","2.70"
"114204","13","13","12","1","10","2.70"
"114410","8","8","8","0","6","2.70"
"114670","18","18","15","3","8","2.70"
"114701","11","11","11","0","7","2.70"
"114962","14","14","13","1","8","2.70"
"114965","11","11","11","0","11","2.70"
"114969","19","19","18","1","11","2.70"
"115038","6","6","6","0","6","2.70"
"115330","17","17","15","2","10","2.70"
"115555","9","9","8","1","6","2.70"
"115594","12","12","12","0","7","2.70"
"115739","9","9","8","1","6","2.70"
"115774","14","14","13","1","7","2.70"
"116316","15","15","14","1","13","2.70"
"116370","14","14","11","3","9","2.70"
"116449","12","12","11","1","7","2.70"
"116568","16","16","12","4","10","2.70"
"116572","17","17","17","0","12","2.70"
"116597","17","17","16","1","10","2.70"
"117186","9","9","9","0","7","2.70"
"117421","12","12","11","1","7","2.70"
"100539","24","24","21","3","15","2.69"
"100870","19","19","18","1","16","2.69"
"101145","20","20","16","4","14","2.69"
"101653","13","13","11","2","9","2.69"
"101930","17","17","15","2","11","2.69"
"102018","19","19","16","3","11","2.69"
"102046","15","15","13","2","9","2.69"
"102069","15","15","14","1","13","2.69"
"102251","14","14","12","2","9","2.69"
"103506","21","21","20","1","15","2.69"
"103786","17","17","15","2","12","2.69"
"104132","14","14","14","0","10","2.69"
"104410","13","13","11","2","10","2.69"
"105284","15","15","14","1","10","2.69"
"105834","20","20","20","0","16","2.69"
"106412","13","13","12","1","9","2.69"
"106515","16","16","14","2","9","2.69"
"106742","17","17","16","1","13","2.69"
"106975","17","17","15","2","11","2.69"
"107410","19","19","18","1","12","2.69"
"107623","14","14","13","1","9","2.69"
"107739","21","21","20","1","13","2.69"
"108142","13","13","13","0","9","2.69"
"108477","26","26","22","4","15","2.69"
"108595","10","10","10","0","8","2.69"
"108636","15","15","14","1","12","2.69"
"108646","17","17","16","1","13","2.69"
"109062","19","19","17","2","12","2.69"
"109363","14","14","13","1","10","2.69"
"109472","12","12","11","1","9","2.69"
"109685","16","16","15","1","9","2.69"
"109862","10","10","10","0","10","2.69"
"110073","24","24","21","3","14","2.69"
"110489","18","18","16","2","12","2.69"
"110859","14","14","14","0","10","2.69"
"111081","16","16","16","0","13","2.69"
"111793","15","15","15","0","11","2.69"
"111974","14","14","12","2","10","2.69"
"112160","24","24","20","4","14","2.69"
"112525","20","20","20","0","11","2.69"
"112982","16","16","13","3","10","2.69"
"113059","15","15","14","1","8","2.69"
"113567","18","18","16","2","12","2.69"
"113922","14","14","14","0","10","2.69"
"114324","19","19","18","1","13","2.69"
"114856","22","22","21","1","13","2.69"
"115927","17","17","16","1","11","2.69"
"116215","16","16","15","1","9","2.69"
"116381","16","16","13","3","10","2.69"
"116665","18","18","16","2","13","2.69"
"116716","17","17","15","2","9","2.69"
"116943","19","19","18","1","8","2.69"
"117202","18","18","18","0","13","2.69"
"117434","16","16","15","1","11","2.69"
"100908","22","22","21","1","17","2.68"
"101473","19","19","15","4","12","2.68"
"101850","19","19","19","0","15","2.68"
"102013","17","17","17","0","14","2.68"
"102734","16","16","16","0","13","2.68"
"104091","17","17","15","2","12","2.68"
"105739","19","19","17","2","12","2.68"
"105776","21","21","19","2","15","2.68"
"106338","14","14","12","2","11","2.68"
"109868","17","17","16","1","12","2.68"
"111029","14","14","14","0","12","2.68"
"112452","15","15","15","0","11","2.68"
"114311","24","24","21","3","18","2.68"
"114982","21","21","18","3","12","2.68"
"115142","19","19","14","5","11","2.68"
"116596","16","16","14","2","12","2.68"
"116640","19","19","18","1","15","2.68"
"116757","15","15","15","0","13","2.68"
"116762","16","16","14","2","11","2.68"
"100091","17","17","14","3","11","2.67"
"100119","10","10","10","0","7","2.67"
"100301","14","14","12","2","8","2.67"
"100361","10","10","9","1","8","2.67"
"100442","15","15","13","2","10","2.67"
"100494","19","19","17","2","13","2.67"
"100678","11","11","10","1","3","2.67"
"100717","10","10","8","2","5","2.67"
"100723","17","17","17","0","15","2.67"
"100728","15","15","14","1","11","2.67"
"100857","11","11","7","4","6","2.67"
"100869","15","15","13","2","7","2.67"
"100958","11","11","10","1","8","2.67"
"100979","21","21","18","3","11","2.67"
"100985","18","18","17","1","10","2.67"
"100998","15","15","13","2","9","2.67"
"101006","14","14","13","1","8","2.67"
"101084","12","12","12","0","10","2.67"
"101250","16","16","13","3","8","2.67"
"101270","20","20","17","3","10","2.67"
"101347","12","12","10","2","5","2.67"
"101361","15","15","14","1","10","2.67"
"101373","18","18","15","3","14","2.67"
"101410","17","17","14","3","8","2.67"
"101439","11","11","9","2","6","2.67"
"101461","11","11","11","0","7","2.67"
"101561","13","13","9","4","5","2.67"
"101563","14","14","11","3","6","2.67"
"101624","17","17","16","1","10","2.67"
"101658","11","11","10","1","6","2.67"
"101761","10","10","8","2","6","2.67"
"101764","14","14","13","1","7","2.67"
"101796","10","10","10","0","8","2.67"
"101983","18","18","18","0","10","2.67"
"102028","16","16","16","0","12","2.67"
"102087","18","18","16","2","9","2.67"
"102117","21","21","16","5","7","2.67"
"102184","13","13","13","0","10","2.67"
"102266","7","7","6","1","3","2.67"
"102275","8","8","7","1","4","2.67"
"102289","10","10","10","0","8","2.67"
"102317","6","6","6","0","4","2.67"
"102329","12","12","9","3","7","2.67"
"102332","15","15","14","1","12","2.67"
"102462","8","8","8","0","6","2.67"
"102501","7","7","5","2","3","2.67"
"102564","9","9","8","1","7","2.67"
"102570","13","13","11","2","9","2.67"
"102574","21","21","18","3","11","2.67"
"102604","11","11","9","2","6","2.67"
"102700","9","9","6","3","6","2.67"
"102740","16","16","15","1","11","2.67"
"102762","16","16","14","2","11","2.67"
"102823","17","17","16","1","14","2.67"
"102877","13","13","12","1","7","2.67"
"102930","10","10","8","2","4","2.67"
"102947","22","22","22","0","16","2.67"
"102951","9","9","8","1","5","2.67"
"103057","18","18","17","1","14","2.67"
"103062","13","13","11","2","9","2.67"
"103094","20","20","18","2","16","2.67"
"103172","16","16","15","1","7","2.67"
"103272","10","10","10","0","5","2.67"
"103416","15","15","12","3","6","2.67"
"103497","11","11","9","2","6","2.67"
"103535","10","10","10","0","9","2.67"
"103556","12","12","12","0","9","2.67"
"103569","17","17","16","1","11","2.67"
"103586","16","16","13","3","7","2.67"
"103599","13","13","11","2","6","2.67"
"103623","17","17","16","1","9","2.67"
"103628","8","8","6","2","5","2.67"
"103656","19","19","17","2","10","2.67"
"103731","10","10","9","1","6","2.67"
"103762","14","14","13","1","9","2.67"
"103840","13","13","11","2","6","2.67"
"103847","7","7","4","3","4","2.67"
"103880","19","19","16","3","13","2.67"
"103936","12","12","11","1","10","2.67"
"104055","6","6","6","0","3","2.67"
"104195","12","12","11","1","11","2.67"
"104209","7","7","6","1","3","2.67"
"104231","11","11","11","0","9","2.67"
"104286","10","10","9","1","6","2.67"
"104321","12","12","11","1","8","2.67"
"104348","16","16","16","0","13","2.67"
"104471","13","13","10","3","7","2.67"
"104480","17","17","15","2","10","2.67"
"104548","14","14","11","3","7","2.67"
"104610","11","11","8","3","8","2.67"
"104652","12","12","11","1","6","2.67"
"104693","14","14","14","0","10","2.67"
"104714","10","10","8","2","4","2.67"
"104750","18","18","16","2","11","2.67"
"104767","17","17","14","3","10","2.67"
"104777","13","13","10","3","8","2.67"
"104812","9","9","8","1","6","2.67"
"104948","11","11","11","0","7","2.67"
"104994","11","11","10","1","7","2.67"
"105050","11","11","9","2","3","2.67"
"105100","9","9","8","1","7","2.67"
"105119","15","15","12","3","10","2.67"
"105143","15","15","15","0","12","2.67"
"105155","13","13","12","1","8","2.67"
"105156","9","9","9","0","6","2.67"
"105346","11","11","9","2","4","2.67"
"105347","9","9","9","0","4","2.67"
"105380","13","12","11","2","5","2.67"
"105451","15","15","12","3","7","2.67"
"105661","17","17","13","4","10","2.67"
"105715","11","11","10","1","7","2.67"
"105775","9","9","7","2","4","2.67"
"105814","6","6","6","0","3","2.67"
"105857","13","13","10","3","4","2.67"
"105939","13","12","10","3","7","2.67"
"105994","13","13","10","3","9","2.67"
"106194","16","16","16","0","8","2.67"
"106217","10","10","8","2","4","2.67"
"106230","8","8","8","0","6","2.67"
"106236","13","13","11","2","8","2.67"
"106240","11","11","10","1","9","2.67"
"106252","19","19","18","1","10","2.67"
"106253","14","14","13","1","10","2.67"
"106308","12","12","12","0","8","2.67"
"106371","8","8","7","1","6","2.67"
"106414","14","14","13","1","7","2.67"
"106493","15","15","12","3","7","2.67"
"106540","13","13","13","0","10","2.67"
"106674","14","14","10","4","8","2.67"
"106715","14","14","13","1","8","2.67"
"106820","20","20","18","2","13","2.67"
"106842","20","20","19","1","12","2.67"
"106856","14","14","10","4","8","2.67"
"107130","19","19","18","1","13","2.67"
"107194","15","15","15","0","11","2.67"
"107215","12","12","11","1","8","2.67"
"107238","19","19","15","4","12","2.67"
"107243","12","12","12","0","8","2.67"
"107261","21","21","16","5","11","2.67"
"107385","14","14","13","1","8","2.67"
"107423","12","12","11","1","4","2.67"
"107459","6","6","4","2","4","2.67"
"107528","14","14","13","1","9","2.67"
"107569","7","7","7","0","4","2.67"
"107706","5","5","4","1","3","2.67"
"107788","8","8","7","1","6","2.67"
"107853","11","11","11","0","6","2.67"
"107856","10","10","9","1","6","2.67"
"107939","14","14","12","2","8","2.67"
"107986","10","10","8","2","6","2.67"
"108036","15","15","11","4","9","2.67"
"108063","7","7","6","1","4","2.67"
"108090","12","12","12","0","8","2.67"
"108106","11","11","11","0","3","2.67"
"108230","13","13","10","3","8","2.67"
"108242","10","10","8","2","3","2.67"
"108335","7","7","7","0","5","2.67"
"108369","12","12","11","1","9","2.67"
"108453","15","15","15","0","12","2.67"
"108526","15","15","14","1","9","2.67"
"108547","14","14","12","2","12","2.67"
"108596","13","13","12","1","10","2.67"
"108633","10","10","9","1","7","2.67"
"108743","7","7","7","0","3","2.67"
"108818","15","15","14","1","9","2.67"
"108842","6","6","5","1","4","2.67"
"108878","14","14","13","1","10","2.67"
"108920","11","11","10","1","9","2.67"
"108947","11","11","9","2","8","2.67"
"108958","13","13","13","0","7","2.67"
"108993","16","16","15","1","13","2.67"
"108999","11","11","6","5","4","2.67"
"109212","14","14","12","2","6","2.67"
"109218","7","7","6","1","4","2.67"
"109256","14","14","12","2","11","2.67"
"109402","14","14","13","1","9","2.67"
"109517","13","13","9","4","6","2.67"
"109672","5","5","5","0","3","2.67"
"109687","12","12","10","2","5","2.67"
"109806","14","14","12","2","8","2.67"
"109827","14","14","13","1","6","2.67"
"109864","10","10","9","1","6","2.67"
"109888","12","12","12","0","9","2.67"
"109999","7","7","5","2","3","2.67"
"110074","8","8","7","1","4","2.67"
"110104","15","15","14","1","13","2.67"
"110171","16","16","12","4","9","2.67"
"110183","15","15","15","0","11","2.67"
"110219","17","17","14","3","9","2.67"
"110225","14","14","13","1","8","2.67"
"110226","16","16","16","0","12","2.67"
"110268","17","17","16","1","10","2.67"
"110311","9","9","7","2","5","2.67"
"110359","18","18","14","4","11","2.67"
"110368","18","18","17","1","10","2.67"
"110371","20","20","17","3","11","2.67"
"110373","15","15","13","2","5","2.67"
"110447","14","14","13","1","10","2.67"
"110548","10","10","10","0","4","2.67"
"110710","16","16","11","5","7","2.67"
"110743","12","12","10","2","7","2.67"
"110889","12","12","10","2","9","2.67"
"111037","10","10","9","1","3","2.67"
"111050","13","13","11","2","6","2.67"
"111192","11","11","10","1","8","2.67"
"111213","8","8","7","1","3","2.67"
"111321","12","12","10","2","7","2.67"
"111389","14","14","14","0","7","2.67"
"111408","9","9","9","0","7","2.67"
"111476","14","14","13","1","8","2.67"
"111679","8","8","8","0","4","2.67"
"111704","12","12","11","1","8","2.67"
"111756","13","13","12","1","8","2.67"
"111828","15","15","15","0","10","2.67"
"112027","7","7","7","0","6","2.67"
"112195","6","6","6","0","6","2.67"
"112218","9","9","8","1","7","2.67"
"112234","9","9","8","1","7","2.67"
"112252","19","19","18","1","12","2.67"
"112261","12","12","11","1","9","2.67"
"112368","9","9","8","1","7","2.67"
"112392","13","13","12","1","6","2.67"
"112467","18","18","18","0","13","2.67"
"112543","16","16","15","1","11","2.67"
"112575","13","13","12","1","9","2.67"
"112772","8","8","8","0","4","2.67"
"112826","23","23","21","2","14","2.67"
"112840","15","15","14","1","12","2.67"
"112888","15","15","14","1","8","2.67"
"112902","15","15","13","2","6","2.67"
"113002","14","14","11","3","7","2.67"
"113012","18","18","16","2","13","2.67"
"113043","15","15","12","3","8","2.67"
"113079","11","11","10","1","8","2.67"
"113112","13","13","12","1","9","2.67"
"113154","16","16","16","0","14","2.67"
"113316","13","13","13","0","8","2.67"
"113319","12","12","9","3","6","2.67"
"113327","8","8","6","2","4","2.67"
"113379","14","14","13","1","10","2.67"
"113449","11","11","9","2","6","2.67"
"113529","8","8","8","0","4","2.67"
"113635","20","20","20","0","13","2.67"
"113754","13","13","11","2","7","2.67"
"113773","11","11","10","1","7","2.67"
"114084","20","20","17","3","12","2.67"
"114200","13","13","13","0","8","2.67"
"114261","19","19","17","2","9","2.67"
"114267","17","17","16","1","12","2.67"
"114319","18","18","18","0","12","2.67"
"114331","14","14","13","1","10","2.67"
"114333","18","18","16","2","9","2.67"
"114363","22","22","19","3","13","2.67"
"114402","14","14","11","3","9","2.67"
"114409","16","16","14","2","8","2.67"
"114485","18","18","15","3","12","2.67"
"114587","17","17","15","2","10","2.67"
"114690","17","17","15","2","9","2.67"
"114708","13","13","12","1","7","2.67"
"114722","14","14","10","4","8","2.67"
"114749","9","9","9","0","7","2.67"
"114877","7","7","5","2","3","2.67"
"114891","15","15","12","3","6","2.67"
"114892","14","14","14","0","8","2.67"
"114992","18","18","17","1","13","2.67"
"115080","12","12","11","1","7","2.67"
"115148","11","11","10","1","7","2.67"
"115171","16","16","13","3","9","2.67"
"115299","12","12","12","0","7","2.67"
"115365","14","14","11","3","10","2.67"
"115366","12","12","10","2","8","2.67"
"115371","21","21","18","3","11","2.67"
"115427","15","15","12","3","12","2.67"
"115450","7","7","7","0","4","2.67"
"115597","11","11","8","3","7","2.67"
"115659","13","13","12","1","7","2.67"
"115848","10","10","9","1","7","2.67"
"115923","20","20","18","2","17","2.67"
"116062","14","14","14","0","10","2.67"
"116160","12","12","10","2","5","2.67"
"116203","18","18","12","6","10","2.67"
"116206","11","11","10","1","7","2.67"
"116248","14","14","14","0","8","2.67"
"116272","13","13","10","3","7","2.67"
"116283","12","12","11","1","4","2.67"
"116550","16","16","14","2","11","2.67"
"116676","8","8","7","1","5","2.67"
"116677","15","15","13","2","8","2.67"
"116697","19","19","17","2","15","2.67"
"116782","13","13","13","0","9","2.67"
"116830","14","14","14","0","8","2.67"
"116903","17","17","17","0","11","2.67"
"117033","11","11","10","1","6","2.67"
"117055","13","13","12","1","9","2.67"
"117100","13","13","10","3","4","2.67"
"117155","11","11","8","3","6","2.67"
"117203","11","11","11","0","6","2.67"
"117211","14","14","10","4","7","2.67"
"117223","9","9","8","1","5","2.67"
"117282","15","15","14","1","11","2.67"
"117305","10","9","8","2","3","2.67"
"117313","11","11","11","0","8","2.67"
"117417","13","13","12","1","7","2.67"
"117426","11","11","9","2","7","2.67"
"117439","14","14","14","0","10","2.67"
"117446","14","14","13","1","12","2.67"
"117541","12","12","11","1","9","2.67"
"117605","14","14","12","2","7","2.67"
"102899","24","24","21","3","17","2.66"
"104986","21","21","20","1","15","2.66"
"106474","19","19","16","3","10","2.66"
"107444","14","14","14","0","13","2.66"
"108209","19","19","17","2","12","2.66"
"112444","16","16","16","0","12","2.66"
"115407","17","17","16","1","13","2.66"
"116237","17","17","16","1","12","2.66"
"100228","14","14","14","0","13","2.65"
"101064","21","21","19","2","16","2.65"
"101619","11","11","10","1","9","2.65"
"101741","15","15","13","2","10","2.65"
"102649","25","25","24","1","15","2.65"
"102802","13","13","13","0","9","2.65"
"103401","16","16","15","1","7","2.65"
"103704","15","15","15","0","10","2.65"
"103981","16","16","16","0","11","2.65"
"105147","20","20","19","1","15","2.65"
"105290","21","21","21","0","15","2.65"
"105611","19","19","18","1","14","2.65"
"105990","21","21","17","4","14","2.65"
"106199","17","17","14","3","10","2.65"
"107036","18","18","15","3","12","2.65"
"107377","26","26","25","1","20","2.65"
"107390","19","19","17","2","13","2.65"
"107453","19","19","15","4","11","2.65"
"107922","17","17","16","1","14","2.65"
"108101","15","15","13","2","10","2.65"
"109478","14","14","13","1","11","2.65"
"110205","21","21","18","3","15","2.65"
"110526","15","15","15","0","14","2.65"
"112123","13","13","12","1","10","2.65"
"112419","12","12","11","1","10","2.65"
"113353","18","18","16","2","13","2.65"
"114018","20","20","18","2","11","2.65"
"114893","23","23","20","3","13","2.65"
"115227","18","18","17","1","11","2.65"
"116894","12","12","12","0","11","2.65"
"117103","13","13","11","2","8","2.65"
"117134","15","15","11","4","11","2.65"
"117450","17","16","14","3","12","2.65"
"117610","22","22","20","2","14","2.65"
"100200","16","16","14","2","10","2.64"
"100201","15","15","15","0","11","2.64"
"100512","15","15","13","2","10","2.64"
"100610","14","14","12","2","11","2.64"
"100719","11","11","9","2","9","2.64"
"100818","16","16","16","0","13","2.64"
"100917","13","13","12","1","11","2.64"
"100928","15","15","14","1","10","2.64"
"101003","15","15","13","2","10","2.64"
"101420","17","17","17","0","14","2.64"
"101754","12","12","10","2","8","2.64"
"102023","15","15","14","1","9","2.64"
"102118","14","14","12","2","10","2.64"
"102202","16","16","16","0","10","2.64"
"102216","16","16","15","1","10","2.64"
"102586","17","17","17","0","13","2.64"
"102981","11","11","11","0","10","2.64"
"103019","11","11","10","1","8","2.64"
"103393","12","12","10","2","8","2.64"
"103792","14","14","12","2","8","2.64"
"103953","13","13","12","1","10","2.64"
"104031","21","21","20","1","13","2.64"
"104245","22","22","18","4","11","2.64"
"104335","16","16","12","4","9","2.64"
"104367","12","12","11","1","9","2.64"
"104828","14","14","12","2","9","2.64"
"104949","15","15","13","2","11","2.64"
"105428","13","13","13","0","9","2.64"
"105535","17","17","16","1","11","2.64"
"105740","13","13","12","1","10","2.64"
"105784","17","17","14","3","11","2.64"
"106205","19","19","17","2","11","2.64"
"106398","21","21","20","1","14","2.64"
"106666","13","13","12","1","11","2.64"
"106712","17","17","15","2","13","2.64"
"106759","16","16","13","3","11","2.64"
"106866","18","18","15","3","9","2.64"
"106869","15","15","15","0","13","2.64"
"107992","24","24","21","3","15","2.64"
"108019","19","19","19","0","10","2.64"
"108067","13","13","11","2","8","2.64"
"108275","14","14","14","0","10","2.64"
"108311","14","14","11","3","9","2.64"
"108794","9","9","9","0","8","2.64"
"108892","18","18","17","1","10","2.64"
"109115","13","13","13","0","9","2.64"
"109797","17","17","14","3","10","2.64"
"109902","13","13","13","0","9","2.64"
"110378","17","17","17","0","13","2.64"
"110588","19","19","18","1","9","2.64"
"110930","12","12","11","1","9","2.64"
"111012","14","14","13","1","8","2.64"
"111697","13","13","11","2","8","2.64"
"111813","17","17","16","1","12","2.64"
"111929","19","19","17","2","11","2.64"
"112121","19","19","18","1","14","2.64"
"112124","14","14","11","3","11","2.64"
"112200","12","12","10","2","9","2.64"
"112343","11","11","9","2","9","2.64"
"112572","11","11","10","1","9","2.64"
"112608","17","17","15","2","13","2.64"
"112671","12","12","10","2","8","2.64"
"112723","14","14","12","2","8","2.64"
"112841","16","16","15","1","8","2.64"
"112901","16","16","15","1","10","2.64"
"113190","13","13","12","1","9","2.64"
"113479","20","20","20","0","11","2.64"
"113507","16","16","15","1","11","2.64"
"113593","16","16","16","0","11","2.64"
"113654","14","14","12","2","9","2.64"
"114553","14","14","12","2","10","2.64"
"114797","14","14","13","1","10","2.64"
"115118","17","17","15","2","10","2.64"
"115212","12","12","11","1","10","2.64"
"115380","18","18","17","1","11","2.64"
"115448","15","15","10","5","9","2.64"
"115538","12","12","12","0","10","2.64"
"115740","14","14","13","1","9","2.64"
"115897","13","13","12","1","8","2.64"
"115939","15","15","12","3","10","2.64"
"116401","15","15","14","1","9","2.64"
"116525","17","17","15","2","12","2.64"
"116541","13","13","10","3","10","2.64"
"116641","12","12","11","1","11","2.64"
"116727","15","15","13","2","11","2.64"
"117125","21","21","15","6","11","2.64"
"100047","16","16","13","3","8","2.63"
"100081","14","14","11","3","10","2.63"
"100429","22","22","20","2","14","2.63"
"100647","21","21","19","2","14","2.63"
"100768","9","9","9","0","5","2.63"
"100891","16","16","14","2","6","2.63"
"100911","14","14","13","1","13","2.63"
"100952","14","14","12","2","11","2.63"
"101086","13","13","11","2","9","2.63"
"101102","12","12","12","0","9","2.63"
"101181","13","13","11","2","8","2.63"
"101595","12","12","11","1","9","2.63"
"101846","8","8","7","1","5","2.63"
"101984","13","13","11","2","5","2.63"
"101991","10","10","9","1","6","2.63"
"102093","9","9","7","2","6","2.63"
"102104","18","18","17","1","12","2.63"
"102384","11","11","9","2","5","2.63"
"102399","16","16","15","1","13","2.63"
"102456","21","21","19","2","12","2.63"
"102976","14","14","13","1","6","2.63"
"103009","6","6","5","1","5","2.63"
"103120","11","11","10","1","6","2.63"
"103143","12","12","12","0","7","2.63"
"103447","15","15","15","0","12","2.63"
"103469","10","10","9","1","8","2.63"
"103479","12","12","11","1","8","2.63"
"103560","11","11","10","1","7","2.63"
"104193","9","9","9","0","6","2.63"
"104241","9","9","9","0","8","2.63"
"104294","12","12","10","2","5","2.63"
"104301","13","13","12","1","8","2.63"
"104310","14","14","12","2","9","2.63"
"104397","23","23","19","4","11","2.63"
"104428","17","17","17","0","12","2.63"
"104436","17","17","13","4","5","2.63"
"104522","11","11","9","2","7","2.63"
"104578","11","11","10","1","7","2.63"
"104597","8","8","7","1","5","2.63"
"104723","11","11","10","1","9","2.63"
"104920","17","17","17","0","10","2.63"
"104928","16","16","12","4","10","2.63"
"105202","10","10","8","2","5","2.63"
"105357","13","13","11","2","10","2.63"
"105588","20","20","17","3","14","2.63"
"105756","12","12","10","2","5","2.63"
"105890","9","9","9","0","5","2.63"
"106248","16","16","15","1","13","2.63"
"106255","23","23","21","2","15","2.63"
"106319","9","9","9","0","5","2.63"
"106550","17","17","16","1","11","2.63"
"106596","15","15","14","1","10","2.63"
"106823","13","13","13","0","6","2.63"
"107002","24","24","22","2","15","2.63"
"107025","19","19","19","0","13","2.63"
"107334","7","7","6","1","5","2.63"
"107543","11","11","11","0","7","2.63"
"107556","15","15","13","2","10","2.63"
"107600","11","11","10","1","7","2.63"
"107651","15","15","15","0","11","2.63"
"107673","8","8","7","1","5","2.63"
"107745","13","13","12","1","7","2.63"
"107806","12","12","12","0","6","2.63"
"107833","12","12","10","2","6","2.63"
"107917","13","13","13","0","8","2.63"
"107981","12","12","10","2","5","2.63"
"108076","20","20","18","2","12","2.63"
"108173","17","17","16","1","13","2.63"
"108507","13","13","12","1","5","2.63"
"108529","12","12","9","3","5","2.63"
"108581","13","13","11","2","7","2.63"
"108612","19","19","18","1","12","2.63"
"108903","14","14","12","2","8","2.63"
"108972","11","11","9","2","5","2.63"
"108987","12","12","11","1","9","2.63"
"109144","10","10","8","2","7","2.63"
"109157","14","14","13","1","9","2.63"
"109428","16","16","15","1","11","2.63"
"109970","10","10","10","0","8","2.63"
"109983","17","17","14","3","9","2.63"
"110011","16","16","15","1","11","2.63"
"110099","9","9","9","0","7","2.63"
"110152","19","19","17","2","10","2.63"
"110348","10","10","9","1","6","2.63"
"110575","12","12","12","0","10","2.63"
"110741","17","17","14","3","13","2.63"
"110934","20","20","18","2","9","2.63"
"110976","17","17","16","1","7","2.63"
"110997","22","22","19","3","10","2.63"
"111161","18","17","16","2","10","2.63"
"111220","20","20","19","1","15","2.63"
"111374","16","16","13","3","12","2.63"
"111715","11","11","10","1","5","2.63"
"111727","19","18","18","1","11","2.63"
"111856","16","16","13","3","10","2.63"
"111941","8","8","8","0","5","2.63"
"111995","13","13","10","3","7","2.63"
"112567","16","16","15","1","9","2.63"
"112636","15","15","13","2","7","2.63"
"112759","8","8","8","0","5","2.63"
"112889","14","14","11","3","6","2.63"
"113136","16","16","16","0","11","2.63"
"113185","12","12","11","1","5","2.63"
"113232","16","16","15","1","12","2.63"
"113357","9","9","9","0","6","2.63"
"113603","10","10","8","2","7","2.63"
"113823","17","17","16","1","8","2.63"
"113981","9","9","8","1","5","2.63"
"113983","19","19","17","2","16","2.63"
"114130","10","10","9","1","5","2.63"
"114179","18","18","14","4","9","2.63"
"114274","16","16","16","0","10","2.63"
"114618","14","14","13","1","9","2.63"
"114788","6","6","6","0","5","2.63"
"114849","11","11","11","0","5","2.63"
"114980","13","13","13","0","11","2.63"
"115211","12","12","10","2","6","2.63"
"115533","16","16","15","1","11","2.63"
"115604","15","15","13","2","6","2.63"
"115658","11","11","11","0","10","2.63"
"115868","15","15","15","0","12","2.63"
"116007","17","17","14","3","11","2.63"
"116073","13","13","10","3","5","2.63"
"116196","15","15","14","1","11","2.63"
"116231","15","15","15","0","13","2.63"
"116241","10","10","10","0","8","2.63"
"116741","15","15","14","1","12","2.63"
"116989","14","14","14","0","11","2.63"
"117015","16","16","14","2","9","2.63"
"117208","12","12","12","0","10","2.63"
"117224","21","21","16","5","11","2.63"
"117263","9","9","9","0","5","2.63"
"117341","14","14","12","2","10","2.63"
"117534","21","21","19","2","17","2.63"
"100254","14","14","13","1","9","2.62"
"100354","15","15","12","3","10","2.62"
"100685","20","20","19","1","11","2.62"
"100938","21","21","18","3","13","2.62"
"101194","15","15","14","1","10","2.62"
"101233","16","16","15","1","13","2.62"
"102166","11","11","11","0","9","2.62"
"102346","16","16","11","5","9","2.62"
"102486","16","15","15","1","10","2.62"
"103844","18","18","15","3","11","2.62"
"103884","17","17","17","0","10","2.62"
"103970","17","17","15","2","11","2.62"
"104166","20","20","17","3","11","2.62"
"105348","17","17","16","1","14","2.62"
"105631","15","15","15","0","12","2.62"
"105861","13","13","12","1","10","2.62"
"106266","25","25","24","1","17","2.62"
"106424","22","22","19","3","13","2.62"
"106758","23","23","18","5","13","2.62"
"107162","16","16","15","1","11","2.62"
"108594","17","17","16","1","11","2.62"
"108904","20","20","16","4","10","2.62"
"109728","17","17","15","2","11","2.62"
"110664","18","18","17","1","12","2.62"
"111102","16","16","15","1","10","2.62"
"114593","17","17","14","3","11","2.62"
"115969","18","18","16","2","12","2.62"
"116621","14","14","13","1","12","2.62"
"117423","19","19","17","2","13","2.62"
"100033","14","13","14","0","14","2.61"
"100104","20","20","18","2","11","2.61"
"100345","21","21","18","3","15","2.61"
"101482","12","12","12","0","11","2.61"
"101626","9","9","9","0","9","2.61"
"102058","13","13","13","0","8","2.61"
"102228","23","23","20","3","10","2.61"
"102300","17","17","16","1","12","2.61"
"103005","12","12","11","1","8","2.61"
"103109","16","16","14","2","13","2.61"
"103446","19","19","18","1","13","2.61"
"103887","18","18","16","2","8","2.61"
"104583","15","15","13","2","8","2.61"
"104644","14","14","14","0","8","2.61"
"105227","15","15","14","1","12","2.61"
"105614","16","16","16","0","14","2.61"
"106400","15","15","13","2","10","2.61"
"106741","12","12","10","2","8","2.61"
"106797","14","14","12","2","9","2.61"
"107117","14","14","13","1","10","2.61"
"108038","16","16","15","1","12","2.61"
"108659","18","18","17","1","10","2.61"
"108687","18","18","17","1","11","2.61"
"108852","17","17","14","3","8","2.61"
"109181","14","14","13","1","8","2.61"
"109501","14","14","11","3","8","2.61"
"110340","18","18","17","1","13","2.61"
"110422","13","13","12","1","12","2.61"
"110642","21","21","18","3","12","2.61"
"110709","11","11","11","0","6","2.61"
"110726","14","14","14","0","10","2.61"
"111048","14","14","12","2","8","2.61"
"111263","20","20","16","4","10","2.61"
"111449","14","14","13","1","9","2.61"
"112135","20","20","19","1","14","2.61"
"112411","20","20","19","1","16","2.61"
"112773","22","22","21","1","14","2.61"
"113623","19","19","18","1","14","2.61"
"113883","15","15","12","3","10","2.61"
"114068","16","16","13","3","10","2.61"
"114840","14","14","12","2","11","2.61"
"115232","12","12","11","1","10","2.61"
"115880","17","17","16","1","13","2.61"
"116022","17","17","17","0","8","2.61"
"116710","12","12","12","0","9","2.61"
"100008","10","10","10","0","8","2.60"
"100203","14","14","12","2","11","2.60"
"100212","13","13","12","1","7","2.60"
"100275","15","15","13","2","11","2.60"
"100284","25","25","21","4","14","2.60"
"100383","13","13","9","4","5","2.60"
"100598","10","10","10","0","6","2.60"
"100644","6","6","6","0","5","2.60"
"100753","12","12","11","1","7","2.60"
"100900","9","9","9","0","6","2.60"
"100931","21","21","20","1","11","2.60"
"101034","12","12","10","2","6","2.60"
"101142","9","9","7","2","5","2.60"
"101162","14","14","12","2","7","2.60"
"101364","11","11","9","2","6","2.60"
"101394","10","10","8","2","6","2.60"
"101774","14","14","13","1","8","2.60"
"101809","9","9","8","1","5","2.60"
"101853","7","7","6","1","5","2.60"
"101913","13","13","12","1","7","2.60"
"102224","16","16","12","4","10","2.60"
"102278","17","17","17","0","12","2.60"
"102315","13","13","13","0","7","2.60"
"102464","8","8","7","1","5","2.60"
"102507","11","11","11","0","7","2.60"
"102768","15","15","13","2","9","2.60"
"102882","15","15","14","1","13","2.60"
"103312","17","17","17","0","11","2.60"
"103383","13","13","12","1","9","2.60"
"103395","13","13","11","2","7","2.60"
"103440","12","12","11","1","9","2.60"
"103510","11","11","11","0","9","2.60"
"103782","11","11","11","0","7","2.60"
"103815","11","11","10","1","8","2.60"
"104191","15","14","13","2","6","2.60"
"104385","14","14","14","0","9","2.60"
"104532","12","12","11","1","6","2.60"
"104666","9","8","9","0","6","2.60"
"104834","10","10","9","1","6","2.60"
"104847","18","18","15","3","8","2.60"
"104978","11","11","11","0","6","2.60"
"105329","12","12","11","1","5","2.60"
"105520","10","10","9","1","7","2.60"
"105524","12","12","11","1","7","2.60"
"105550","12","12","8","4","5","2.60"
"105568","15","15","13","2","11","2.60"
"105579","12","12","12","0","8","2.60"
"105644","16","16","16","0","8","2.60"
"105892","8","8","6","2","6","2.60"
"105935","11","11","11","0","8","2.60"
"105962","11","11","11","0","5","2.60"
"105980","12","12","10","2","7","2.60"
"106149","8","8","8","0","5","2.60"
"106159","11","11","9","2","6","2.60"
"106306","14","14","14","0","7","2.60"
"106316","9","9","9","0","7","2.60"
"106372","13","13","12","1","9","2.60"
"106390","16","16","14","2","8","2.60"
"106442","15","15","14","1","10","2.60"
"106483","17","17","15","2","12","2.60"
"106508","17","17","15","2","11","2.60"
"106534","12","12","11","1","7","2.60"
"106631","16","16","16","0","11","2.60"
"106672","8","8","7","1","7","2.60"
"106952","12","12","11","1","6","2.60"
"107328","8","8","7","1","5","2.60"
"107542","15","15","13","2","10","2.60"
"107548","11","11","8","3","6","2.60"
"107831","8","8","6","2","6","2.60"
"107870","20","20","19","1","17","2.60"
"108115","15","15","14","1","8","2.60"
"108185","13","13","12","1","6","2.60"
"108349","18","18","14","4","9","2.60"
"108392","10","10","10","0","6","2.60"
"108432","18","18","13","5","6","2.60"
"108521","14","14","12","2","7","2.60"
"108531","14","14","12","2","7","2.60"
"108617","12","12","11","1","8","2.60"
"108942","8","8","8","0","5","2.60"
"108968","8","8","7","1","6","2.60"
"109071","12","11","11","1","8","2.60"
"109125","11","11","11","0","7","2.60"
"109240","19","19","17","2","9","2.60"
"109589","13","13","12","1","7","2.60"
"109740","18","18","16","2","9","2.60"
"109808","8","8","7","1","6","2.60"
"109944","17","17","14","3","6","2.60"
"109959","9","9","9","0","5","2.60"
"109962","10","10","8","2","7","2.60"
"110117","13","13","11","2","6","2.60"
"110372","15","15","12","3","7","2.60"
"110413","20","20","18","2","15","2.60"
"110421","10","10","9","1","5","2.60"
"110439","13","13","13","0","6","2.60"
"110443","12","12","11","1","6","2.60"
"110563","8","8","7","1","7","2.60"
"110732","18","18","17","1","8","2.60"
"110801","13","13","13","0","7","2.60"
"110807","7","7","7","0","5","2.60"
"110811","15","15","13","2","12","2.60"
"110885","11","11","8","3","5","2.60"
"110918","12","12","12","0","8","2.60"
"110979","14","14","12","2","7","2.60"
"111067","12","12","9","3","7","2.60"
"111132","19","19","19","0","17","2.60"
"111248","9","9","8","1","5","2.60"
"111270","11","11","11","0","7","2.60"
"111404","16","16","14","2","8","2.60"
"111540","14","14","14","0","10","2.60"
"111611","10","10","9","1","5","2.60"
"111645","12","12","12","0","8","2.60"
"111791","12","12","12","0","7","2.60"
"111954","14","14","14","0","6","2.60"
"112037","17","17","16","1","11","2.60"
"112069","12","12","11","1","6","2.60"
"112072","15","15","15","0","7","2.60"
"112086","13","13","11","2","7","2.60"
"112212","19","19","14","5","9","2.60"
"112314","17","17","16","1","14","2.60"
"112426","11","11","11","0","7","2.60"
"112428","10","10","7","3","6","2.60"
"112482","6","6","6","0","5","2.60"
"112588","9","9","7","2","7","2.60"
"112641","16","16","16","0","12","2.60"
"112651","16","16","13","3","9","2.60"
"112763","16","16","15","1","12","2.60"
"112837","16","16","15","1","11","2.60"
"112855","12","12","10","2","9","2.60"
"112910","12","12","10","2","7","2.60"
"112918","12","12","11","1","8","2.60"
"113114","8","8","7","1","6","2.60"
"113476","11","11","10","1","8","2.60"
"113496","11","11","8","3","6","2.60"
"113552","10","10","8","2","7","2.60"
"113900","14","14","13","1","7","2.60"
"113993","11","11","11","0","8","2.60"
"114133","12","12","11","1","5","2.60"
"114187","16","16","14","2","9","2.60"
"114251","10","10","10","0","7","2.60"
"114306","11","11","9","2","6","2.60"
"114309","12","12","12","0","7","2.60"
"114510","17","17","15","2","11","2.60"
"114511","10","10","7","3","5","2.60"
"114550","9","9","8","1","5","2.60"
"114757","15","15","13","2","9","2.60"
"114951","12","12","10","2","5","2.60"
"115191","11","11","11","0","6","2.60"
"115327","9","9","8","1","6","2.60"
"115339","10","10","9","1","6","2.60"
"115345","8","8","8","0","5","2.60"
"115382","18","18","17","1","16","2.60"
"115514","11","11","10","1","6","2.60"
"115531","14","14","11","3","7","2.60"
"115726","17","17","15","2","10","2.60"
"116016","10","10","9","1","6","2.60"
"116284","11","11","10","1","5","2.60"
"116411","12","12","10","2","7","2.60"
"116496","10","10","10","0","5","2.60"
"116669","16","16","14","2","6","2.60"
"116713","12","12","10","2","6","2.60"
"116721","12","12","9","3","6","2.60"
"116773","12","12","12","0","8","2.60"
"116798","17","17","17","0","8","2.60"
"116862","15","15","11","4","10","2.60"
"116921","10","10","9","1","5","2.60"
"117000","12","12","12","0","8","2.60"
"117047","10","10","8","2","5","2.60"
"117139","12","12","12","0","7","2.60"
"117147","11","10","11","0","6","2.60"
"117251","9","9","9","0","7","2.60"
"117252","9","9","8","1","5","2.60"
"117295","13","13","13","0","8","2.60"
"117424","15","15","14","1","6","2.60"
"117442","16","16","16","0","11","2.60"
"117443","14","14","12","2","8","2.60"
"117575","12","12","12","0","5","2.60"
"117585","21","21","19","2","14","2.60"
"101060","17","17","17","0","14","2.59"
"102484","21","21","21","0","15","2.59"
"104563","15","15","14","1","11","2.59"
"104988","14","14","12","2","11","2.59"
"106142","22","22","18","4","14","2.59"
"107112","23","23","22","1","18","2.59"
"107530","19","19","18","1","13","2.59"
"110625","19","19","18","1","13","2.59"
"110656","21","20","19","2","14","2.59"
"111091","15","15","15","0","12","2.59"
"112162","18","18","15","3","12","2.59"
"113984","15","15","14","1","12","2.59"
"117243","21","21","19","2","15","2.59"
"100007","13","13","12","1","7","2.58"
"100297","14","14","13","1","10","2.58"
"100489","17","17","17","0","10","2.58"
"100579","16","16","13","3","10","2.58"
"100694","15","15","14","1","12","2.58"
"100828","8","8","8","0","7","2.58"
"100856","7","7","7","0","7","2.58"
"100875","11","11","11","0","10","2.58"
"101144","14","14","12","2","7","2.58"
"101197","13","13","12","1","9","2.58"
"101280","17","17","17","0","9","2.58"
"101381","12","12","11","1","7","2.58"
"101509","14","14","13","1","9","2.58"
"101849","12","12","12","0","8","2.58"
"101941","26","26","24","2","17","2.58"
"101966","23","23","22","1","14","2.58"
"102085","17","17","14","3","12","2.58"
"102750","19","19","17","2","11","2.58"
"102789","14","14","12","2","6","2.58"
"103042","11","11","11","0","9","2.58"
"103103","10","10","9","1","6","2.58"
"103174","14","14","14","0","12","2.58"
"103365","13","13","13","0","9","2.58"
"103394","11","11","10","1","6","2.58"
"103504","17","17","16","1","11","2.58"
"103934","13","13","12","1","9","2.58"
"104068","12","12","10","2","8","2.58"
"104203","11","11","11","0","8","2.58"
"104713","10","10","10","0","7","2.58"
"104912","14","14","12","2","10","2.58"
"105405","14","14","14","0","11","2.58"
"105494","16","16","16","0","13","2.58"
"105729","15","15","14","1","9","2.58"
"105839","7","7","6","1","6","2.58"
"105988","21","21","18","3","10","2.58"
"106189","11","11","11","0","8","2.58"
"106224","9","9","7","2","6","2.58"
"106877","12","12","12","0","8","2.58"
"106921","14","14","12","2","10","2.58"
"107472","12","12","11","1","8","2.58"
"107629","20","20","20","0","17","2.58"
"107649","13","13","11","2","8","2.58"
"107857","9","9","9","0","7","2.58"
"108249","15","15","13","2","11","2.58"
"108288","14","14","11","3","8","2.58"
"108436","13","13","11","2","7","2.58"
"108588","13","13","12","1","10","2.58"
"108865","12","12","10","2","6","2.58"
"109013","16","16","16","0","8","2.58"
"109297","15","15","12","3","9","2.58"
"109322","13","13","11","2","8","2.58"
"109326","13","13","10","3","7","2.58"
"109332","24","24","24","0","17","2.58"
"109384","17","17","15","2","14","2.58"
"109452","16","16","13","3","10","2.58"
"109530","13","13","12","1","10","2.58"
"109823","13","13","13","0","6","2.58"
"109975","9","9","8","1","8","2.58"
"110142","13","13","11","2","9","2.58"
"110206","14","14","12","2","8","2.58"
"110409","14","14","11","3","9","2.58"
"110620","10","10","9","1","6","2.58"
"110754","10","10","8","2","6","2.58"
"110847","21","21","19","2","16","2.58"
"111078","14","14","13","1","10","2.58"
"111087","24","24","22","2","15","2.58"
"111144","14","14","13","1","8","2.58"
"111201","15","15","14","1","10","2.58"
"111245","12","12","11","1","7","2.58"
"111854","13","13","12","1","8","2.58"
"111964","14","14","13","1","7","2.58"
"112269","14","14","13","1","7","2.58"
"112280","15","15","13","2","11","2.58"
"112299","12","12","10","2","8","2.58"
"112474","11","11","10","1","9","2.58"
"112511","14","14","13","1","9","2.58"
"112557","10","10","10","0","6","2.58"
"113133","12","12","10","2","7","2.58"
"113201","13","13","11","2","7","2.58"
"113215","15","15","12","3","7","2.58"
"113310","13","13","11","2","7","2.58"
"113311","12","12","9","3","7","2.58"
"113393","14","14","10","4","7","2.58"
"113489","15","15","12","3","7","2.58"
"113634","16","16","14","2","10","2.58"
"113791","8","8","7","1","6","2.58"
"113840","12","12","9","3","6","2.58"
"113861","17","17","14","3","10","2.58"
"114003","13","13","11","2","8","2.58"
"114100","13","13","12","1","8","2.58"
"114607","16","16","14","2","9","2.58"
"114777","12","12","12","0","10","2.58"
"114943","13","13","12","1","9","2.58"
"115094","15","15","15","0","11","2.58"
"115141","10","10","10","0","6","2.58"
"115146","9","9","9","0","7","2.58"
"115241","15","15","14","1","10","2.58"
"115282","18","18","16","2","13","2.58"
"115334","10","10","9","1","9","2.58"
"115355","14","14","10","4","7","2.58"
"115385","8","8","8","0","6","2.58"
"115405","12","12","10","2","7","2.58"
"115413","16","16","14","2","9","2.58"
"115484","9","9","9","0","7","2.58"
"115706","8","8","8","0","6","2.58"
"115708","15","15","14","1","11","2.58"
"116006","13","13","13","0","8","2.58"
"116138","13","13","11","2","7","2.58"
"116220","10","10","10","0","9","2.58"
"116242","21","21","16","5","7","2.58"
"116396","19","19","19","0","11","2.58"
"116518","14","14","12","2","9","2.58"
"116635","13","13","8","5","7","2.58"
"116817","12","12","11","1","8","2.58"
"116825","18","18","18","0","9","2.58"
"116932","14","14","13","1","9","2.58"
"117173","9","9","9","0","7","2.58"
"117404","10","10","10","0","6","2.58"
"117425","14","14","12","2","7","2.58"
"117482","10","10","10","0","7","2.58"
"117608","15","15","13","2","8","2.58"
"100060","15","15","14","1","9","2.57"
"100121","15","15","12","3","10","2.57"
"100318","15","15","14","1","11","2.57"
"100460","12","12","12","0","9","2.57"
"100525","17","17","15","2","12","2.57"
"100574","18","18","17","1","13","2.57"
"100766","23","23","20","3","11","2.57"
"101395","14","14","12","2","10","2.57"
"102173","13","13","12","1","11","2.57"
"102569","14","14","13","1","9","2.57"
"102751","14","14","11","3","8","2.57"
"102863","16","16","14","2","9","2.57"
"102864","19","19","18","1","12","2.57"
"102911","10","10","10","0","9","2.57"
"103893","16","16","16","0","10","2.57"
"104062","19","19","17","2","13","2.57"
"104099","16","16","16","0","11","2.57"
"104117","10","10","10","0","8","2.57"
"104379","20","20","19","1","16","2.57"
"104448","14","14","14","0","11","2.57"
"104598","12","12","12","0","8","2.57"
"104667","12","12","11","1","9","2.57"
"104668","10","10","9","1","8","2.57"
"104683","10","10","10","0","9","2.57"
"104762","19","19","18","1","12","2.57"
"104927","16","16","15","1","10","2.57"
"104961","20","20","17","3","13","2.57"
"105398","10","10","10","0","8","2.57"
"105482","15","15","14","1","11","2.57"
"105706","14","14","14","0","8","2.57"
"105872","11","11","11","0","8","2.57"
"105893","11","11","9","2","7","2.57"
"105921","15","15","14","1","12","2.57"
"106099","12","12","11","1","9","2.57"
"106277","17","16","13","4","10","2.57"
"107078","16","16","14","2","9","2.57"
"107391","17","17","15","2","12","2.57"
"107398","16","16","16","0","13","2.57"
"107433","13","13","13","0","11","2.57"
"107637","16","16","15","1","11","2.57"
"107663","17","17","15","2","9","2.57"
"108284","14","14","13","1","11","2.57"
"108769","18","18","15","3","11","2.57"
"109134","15","15","15","0","12","2.57"
"109246","11","11","11","0","11","2.57"
"109258","19","19","16","3","8","2.57"
"109308","17","17","15","2","8","2.57"
"109387","17","17","14","3","7","2.57"
"109630","20","20","19","1","14","2.57"
"110245","20","20","19","1","12","2.57"
"110510","15","15","14","1","10","2.57"
"110643","15","15","12","3","9","2.57"
"110769","11","11","11","0","9","2.57"
"110962","13","13","10","3","8","2.57"
"111135","11","11","10","1","8","2.57"
"111272","17","17","15","2","11","2.57"
"111274","18","18","15","3","11","2.57"
"111397","13","13","12","1","9","2.57"
"111402","14","14","14","0","9","2.57"
"111489","14","14","14","0","9","2.57"
"111677","15","15","13","2","10","2.57"
"112015","13","13","13","0","10","2.57"
"112239","15","15","14","1","8","2.57"
"112664","12","12","10","2","8","2.57"
"112802","12","12","12","0","9","2.57"
"112892","11","11","11","0","7","2.57"
"113142","14","14","12","2","7","2.57"
"113211","19","19","18","1","17","2.57"
"113378","19","19","18","1","13","2.57"
"113596","11","11","9","2","8","2.57"
"113857","17","17","16","1","10","2.57"
"114194","15","15","12","3","7","2.57"
"114327","15","15","13","2","9","2.57"
"114359","19","19","17","2","12","2.57"
"114398","14","14","13","1","10","2.57"
"115296","15","15","14","1","9","2.57"
"115461","16","16","12","4","11","2.57"
"115665","13","13","13","0","10","2.57"
"115680","16","16","15","1","10","2.57"
"115944","18","18","14","4","9","2.57"
"116083","18","18","15","3","8","2.57"
"116426","13","13","10","3","8","2.57"
"116451","12","12","12","0","8","2.57"
"116800","11","11","11","0","9","2.57"
"117022","15","15","15","0","8","2.57"
"117373","17","17","14","3","9","2.57"
"117411","18","17","16","2","16","2.57"
"100530","16","16","15","1","11","2.56"
"100808","14","14","11","3","7","2.56"
"101030","21","21","20","1","12","2.56"
"101426","16","16","14","2","12","2.56"
"101711","18","18","15","3","10","2.56"
"101878","23","23","22","1","12","2.56"
"102025","15","15","14","1","10","2.56"
"102061","18","18","16","2","13","2.56"
"102143","16","16","14","2","10","2.56"
"102336","12","12","12","0","9","2.56"
"102547","21","21","19","2","13","2.56"
"102568","14","14","10","4","8","2.56"
"102571","14","14","13","1","9","2.56"
"102934","16","16","13","3","9","2.56"
"103020","13","13","13","0","7","2.56"
"103318","19","19","17","2","11","2.56"
"103717","16","16","14","2","10","2.56"
"103734","14","14","14","0","12","2.56"
"103963","13","13","12","1","10","2.56"
"104152","18","18","14","4","9","2.56"
"104585","17","17","16","1","12","2.56"
"104612","14","14","11","3","9","2.56"
"104624","19","19","17","2","12","2.56"
"104754","11","11","11","0","9","2.56"
"105035","15","15","14","1","10","2.56"
"105467","16","16","14","2","9","2.56"
"105522","17","17","16","1","13","2.56"
"105767","11","11","9","2","7","2.56"
"106311","12","12","10","2","8","2.56"
"106376","7","7","6","1","5","2.56"
"106378","16","16","12","4","10","2.56"
"106469","17","17","16","1","10","2.56"
"106490","13","13","13","0","8","2.56"
"106548","14","14","13","1","9","2.56"
"106647","16","16","14","2","12","2.56"
"106793","14","14","13","1","9","2.56"
"107171","14","14","12","2","10","2.56"
"107882","20","20","18","2","11","2.56"
"107907","19","18","18","1","11","2.56"
"108461","16","16","16","0","8","2.56"
"109046","18","18","15","3","14","2.56"
"109094","18","18","18","0","10","2.56"
"109282","23","23","23","0","17","2.56"
"109284","18","18","17","1","14","2.56"
"109397","11","11","9","2","6","2.56"
"109419","14","14","12","2","8","2.56"
"109774","16","16","16","0","12","2.56"
"110096","16","16","16","0","10","2.56"
"110404","12","12","11","1","9","2.56"
"110607","13","13","11","2","11","2.56"
"110723","22","22","18","4","10","2.56"
"111621","17","17","16","1","11","2.56"
"112063","15","15","14","1","9","2.56"
"112894","17","17","14","3","10","2.56"
"113019","17","17","15","2","11","2.56"
"113069","18","18","18","0","15","2.56"
"113236","19","19","14","5","9","2.56"
"113264","17","17","17","0","11","2.56"
"113742","18","18","16","2","11","2.56"
"113849","15","15","15","0","11","2.56"
"114009","12","12","12","0","9","2.56"
"114195","13","13","13","0","11","2.56"
"114646","17","17","15","2","11","2.56"
"114944","16","16","15","1","11","2.56"
"115234","16","16","14","2","10","2.56"
"115553","15","15","13","2","10","2.56"
"115605","11","11","10","1","7","2.56"
"115688","14","14","13","1","11","2.56"
"115713","13","13","11","2","8","2.56"
"115827","13","13","12","1","9","2.56"
"115991","13","13","12","1","8","2.56"
"116026","13","13","12","1","8","2.56"
"116090","16","16","15","1","8","2.56"
"116191","15","15","10","5","9","2.56"
"116229","12","12","12","0","8","2.56"
"116230","14","14","13","1","11","2.56"
"116979","8","8","8","0","6","2.56"
"117543","16","16","14","2","11","2.56"
"101067","16","16","13","3","11","2.55"
"101424","13","13","12","1","10","2.55"
"101459","20","20","19","1","13","2.55"
"102818","14","14","14","0","10","2.55"
"103387","14","14","14","0","10","2.55"
"103448","12","12","12","0","11","2.55"
"104999","14","14","13","1","8","2.55"
"105354","23","23","19","4","16","2.55"
"106713","13","13","11","2","9","2.55"
"107086","15","15","15","0","11","2.55"
"107219","17","17","15","2","9","2.55"
"108451","15","15","15","0","8","2.55"
"109732","17","17","13","4","9","2.55"
"109915","17","17","16","1","12","2.55"
"110038","11","11","11","0","10","2.55"
"110278","16","16","14","2","12","2.55"
"110461","15","15","15","0","10","2.55"
"110876","13","13","13","0","11","2.55"
"111412","18","18","17","1","12","2.55"
"111823","18","18","17","1","12","2.55"
"111935","15","15","14","1","11","2.55"
"112923","15","15","13","2","9","2.55"
"113747","22","22","20","2","15","2.55"
"113794","18","18","15","3","10","2.55"
"114275","12","12","11","1","8","2.55"
"114303","13","13","13","0","10","2.55"
"114353","17","17","15","2","9","2.55"
"114425","14","14","13","1","10","2.55"
"114908","14","14","13","1","10","2.55"
"115281","14","14","13","1","11","2.55"
"115361","16","16","16","0","12","2.55"
"115485","15","15","15","0","12","2.55"
"100099","19","19","18","1","14","2.54"
"101143","15","15","15","0","11","2.54"
"101615","15","15","11","4","10","2.54"
"104233","16","16","14","2","12","2.54"
"104344","18","18","17","1","13","2.54"
"104851","15","15","14","1","11","2.54"
"104902","14","14","12","2","11","2.54"
"105245","18","18","17","1","12","2.54"
"105345","18","18","18","0","14","2.54"
"105854","18","18","16","2","13","2.54"
"105883","21","21","20","1","11","2.54"
"106169","17","17","17","0","12","2.54"
"106203","18","18","15","3","11","2.54"
"106995","14","14","13","1","12","2.54"
"107711","21","21","19","2","10","2.54"
"107844","13","13","12","1","7","2.54"
"107892","26","26","23","3","14","2.54"
"108491","18","18","15","3","13","2.54"
"108724","13","13","13","0","10","2.54"
"108757","14","14","13","1","11","2.54"
"108779","16","16","16","0","12","2.54"
"109097","14","14","11","3","7","2.54"
"109763","18","18","17","1","12","2.54"
"110107","20","20","18","2","13","2.54"
"110243","22","22","21","1","14","2.54"
"110523","15","15","15","0","12","2.54"
"111266","13","13","12","1","7","2.54"
"112539","18","18","17","1","11","2.54"
"112794","14","14","13","1","9","2.54"
"113036","19","19","19","0","12","2.54"
"113194","15","15","13","2","11","2.54"
"113744","15","15","14","1","11","2.54"
"113796","15","15","14","1","12","2.54"
"114140","13","12","11","2","7","2.54"
"114720","16","16","14","2","11","2.54"
"115504","17","17","17","0","15","2.54"
"116165","19","19","19","0","15","2.54"
"116466","22","22","21","1","15","2.54"
"116674","12","12","11","1","8","2.54"
"117025","13","13","12","1","12","2.54"
"117056","14","14","14","0","10","2.54"
"117106","12","12","11","1","7","2.54"
"117377","22","22","17","5","12","2.54"
"100338","9","9","9","0","7","2.53"
"100462","14","14","14","0","9","2.53"
"100527","19","19","18","1","12","2.53"
"101218","20","20","17","3","11","2.53"
"101807","17","17","16","1","9","2.53"
"101817","13","13","11","2","9","2.53"
"101990","15","15","14","1","8","2.53"
"102472","11","11","9","2","8","2.53"
"102552","17","17","14","3","10","2.53"
"102719","13","13","10","3","8","2.53"
"102953","18","18","16","2","11","2.53"
"103212","18","18","14","4","10","2.53"
"103343","18","18","16","2","12","2.53"
"103741","13","13","10","3","7","2.53"
"103807","15","15","11","4","7","2.53"
"104415","17","17","16","1","11","2.53"
"104931","17","17","14","3","10","2.53"
"105089","15","15","13","2","10","2.53"
"106047","15","15","14","1","8","2.53"
"106504","12","12","11","1","10","2.53"
"107047","11","11","11","0","7","2.53"
"107592","17","17","17","0","10","2.53"
"108486","22","22","22","0","16","2.53"
"108525","15","15","15","0","7","2.53"
"108639","17","17","15","2","7","2.53"
"109524","10","10","10","0","9","2.53"
"109691","13","13","11","2","10","2.53"
"110448","10","10","9","1","8","2.53"
"111277","19","19","18","1","9","2.53"
"111703","11","11","11","0","7","2.53"
"112074","17","17","14","3","12","2.53"
"112328","12","12","11","1","9","2.53"
"112412","15","15","14","1","10","2.53"
"112500","19","19","18","1","8","2.53"
"112540","18","18","15","3","8","2.53"
"113016","18","18","17","1","13","2.53"
"113065","17","17","17","0","14","2.53"
"113356","18","18","18","0","16","2.53"
"113741","19","19","18","1","14","2.53"
"113853","20","20","18","2","14","2.53"
"114135","14","14","12","2","9","2.53"
"114619","16","16","16","0","13","2.53"
"114822","14","14","14","0","11","2.53"
"114873","17","17","14","3","13","2.53"
"115216","17","17","15","2","9","2.53"
"117074","15","15","13","2","12","2.53"
"117096","19","19","17","2","11","2.53"
"101229","15","15","13","2","11","2.52"
"102026","14","14","14","0","11","2.52"
"102032","18","18","18","0","12","2.52"
"102170","15","15","15","0","13","2.52"
"103412","14","14","10","4","10","2.52"
"103452","17","17","15","2","9","2.52"
"103795","14","13","13","1","12","2.52"
"104039","18","18","17","1","11","2.52"
"104349","14","14","14","0","10","2.52"
"104751","17","17","16","1","13","2.52"
"105952","19","19","17","2","12","2.52"
"106186","18","18","17","1","13","2.52"
"106364","19","19","17","2","13","2.52"
"106402","22","22","19","3","14","2.52"
"107413","18","18","15","3","9","2.52"
"108129","17","17","17","0","14","2.52"
"108235","12","12","11","1","10","2.52"
"110821","15","14","14","1","12","2.52"
"110828","20","20","17","3","12","2.52"
"111674","18","18","15","3","15","2.52"
"112061","19","19","17","2","9","2.52"
"112193","23","23","21","2","17","2.52"
"113822","20","20","20","0","14","2.52"
"115729","17","17","17","0","12","2.52"
"115732","14","14","13","1","11","2.52"
"115907","18","18","17","1","13","2.52"
"116503","12","12","10","2","10","2.52"
"116820","14","14","14","0","10","2.52"
"117031","22","22","22","0","16","2.52"
"117379","18","18","17","1","11","2.52"
"100921","23","23","20","3","16","2.51"
"103219","16","16","15","1","11","2.51"
"106314","17","17","16","1","13","2.51"
"108642","21","21","18","3","12","2.51"
"116945","18","18","17","1","13","2.51"
"100037","13","13","12","1","8","2.50"
"100143","14","14","13","1","10","2.50"
"100202","15","15","14","1","8","2.50"
"100211","12","12","11","1","5","2.50"
"100242","19","19","18","1","15","2.50"
"100245","17","17","14","3","7","2.50"
"100285","12","12","10","2","4","2.50"
"100327","13","13","12","1","7","2.50"
"100368","15","15","12","3","11","2.50"
"100468","13","13","12","1","8","2.50"
"100498","19","19","18","1","10","2.50"
"100548","16","16","15","1","10","2.50"
"100561","10","10","6","4","4","2.50"
"100575","7","7","6","1","4","2.50"
"100646","15","15","13","2","7","2.50"
"100649","7","7","7","0","4","2.50"
"100779","13","13","10","3","8","2.50"
"100844","12","12","12","0","8","2.50"
"100924","15","15","15","0","10","2.50"
"100954","10","10","10","0","7","2.50"
"100973","11","11","10","1","6","2.50"
"101045","12","12","12","0","8","2.50"
"101050","12","12","10","2","8","2.50"
"101100","16","16","12","4","7","2.50"
"101101","18","18","15","3","12","2.50"
"101150","10","10","8","2","5","2.50"
"101179","12","12","11","1","9","2.50"
"101241","11","11","10","1","6","2.50"
"101316","9","9","7","2","4","2.50"
"101349","11","11","10","1","5","2.50"
"101406","10","10","9","1","5","2.50"
"101504","21","20","20","1","13","2.50"
"101523","5","5","5","0","4","2.50"
"101534","12","12","11","1","8","2.50"
"101535","18","18","18","0","12","2.50"
"101539","11","11","11","0","8","2.50"
"101547","11","11","9","2","9","2.50"
"101616","14","14","13","1","9","2.50"
"101672","11","11","8","3","5","2.50"
"101760","12","12","10","2","3","2.50"
"101765","8","8","7","1","4","2.50"
"101770","12","12","9","3","4","2.50"
"101788","10","10","8","2","5","2.50"
"101813","22","22","21","1","15","2.50"
"101877","14","14","14","0","12","2.50"
"101908","7","7","7","0","6","2.50"
"101938","16","16","16","0","14","2.50"
"101979","13","13","10","3","6","2.50"
"102092","18","18","17","1","10","2.50"
"102121","16","16","16","0","12","2.50"
"102163","14","14","14","0","10","2.50"
"102192","10","10","10","0","7","2.50"
"102229","13","13","12","1","8","2.50"
"102354","13","13","13","0","8","2.50"
"102427","21","21","21","0","14","2.50"
"102443","11","11","11","0","9","2.50"
"102535","7","7","7","0","6","2.50"
"102608","16","16","15","1","11","2.50"
"102638","16","16","16","0","11","2.50"
"102695","16","16","15","1","7","2.50"
"102715","18","18","15","3","8","2.50"
"102721","13","13","12","1","11","2.50"
"102824","16","16","16","0","8","2.50"
"102857","13","13","10","3","5","2.50"
"102865","10","10","9","1","9","2.50"
"102957","13","12","9","4","3","2.50"
"102971","14","14","13","1","6","2.50"
"102974","18","18","18","0","11","2.50"
"102984","18","18","16","2","12","2.50"
"102987","18","18","14","4","6","2.50"
"103030","12","12","11","1","9","2.50"
"103046","11","11","8","3","6","2.50"
"103083","10","10","9","1","4","2.50"
"103200","8","8","7","1","2","2.50"
"103206","12","12","12","0","7","2.50"
"103244","17","17","14","3","6","2.50"
"103271","12","12","11","1","9","2.50"
"103290","10","10","9","1","5","2.50"
"103296","10","10","10","0","6","2.50"
"103324","18","18","16","2","13","2.50"
"103334","15","15","15","0","13","2.50"
"103355","9","9","8","1","4","2.50"
"103361","12","12","12","0","8","2.50"
"103458","10","10","10","0","4","2.50"
"103489","11","11","11","0","6","2.50"
"103592","10","10","10","0","9","2.50"
"103598","15","15","13","2","9","2.50"
"103618","7","7","7","0","7","2.50"
"103619","12","12","12","0","6","2.50"
"103664","13","12","13","0","10","2.50"
"103700","17","17","14","3","12","2.50"
"103713","7","7","6","1","4","2.50"
"103732","14","14","14","0","11","2.50"
"103825","15","15","14","1","7","2.50"
"103834","19","19","17","2","12","2.50"
"103917","10","10","9","1","6","2.50"
"103946","9","9","8","1","4","2.50"
"103972","12","12","11","1","9","2.50"
"103995","8","8","7","1","4","2.50"
"104006","13","13","13","0","12","2.50"
"104022","11","11","11","0","8","2.50"
"104110","13","13","11","2","10","2.50"
"104133","11","11","10","1","7","2.50"
"104154","9","9","9","0","5","2.50"
"104175","15","15","12","3","5","2.50"
"104187","16","16","14","2","10","2.50"
"104194","14","14","13","1","7","2.50"
"104254","19","19","18","1","13","2.50"
"104269","9","9","8","1","7","2.50"
"104275","15","15","15","0","11","2.50"
"104282","8","8","8","0","4","2.50"
"104285","9","9","9","0","8","2.50"
"104302","11","11","10","1","4","2.50"
"104304","21","21","20","1","13","2.50"
"104352","10","10","10","0","7","2.50"
"104390","14","14","12","2","9","2.50"
"104452","12","12","11","1","9","2.50"
"104466","12","12","12","0","9","2.50"
"104467","14","14","11","3","9","2.50"
"104506","10","10","9","1","6","2.50"
"104572","17","17","16","1","9","2.50"
"104606","12","12","8","4","6","2.50"
"104648","17","17","15","2","7","2.50"
"104672","7","7","6","1","4","2.50"
"104734","14","14","13","1","9","2.50"
"104799","11","11","9","2","6","2.50"
"104838","17","17","16","1","7","2.50"
"104860","17","17","16","1","9","2.50"
"104941","17","17","15","2","10","2.50"
"104946","8","8","8","0","4","2.50"
"104985","10","10","10","0","7","2.50"
"105069","17","17","17","0","9","2.50"
"105118","12","12","12","0","11","2.50"
"105161","19","19","19","0","12","2.50"
"105167","19","19","14","5","9","2.50"
"105188","18","18","16","2","12","2.50"
"105199","12","12","9","3","6","2.50"
"105206","14","14","13","1","8","2.50"
"105230","10","10","9","1","6","2.50"
"105242","10","10","10","0","9","2.50"
"105263","6","6","5","1","3","2.50"
"105270","14","14","12","2","9","2.50"
"105303","21","21","19","2","12","2.50"
"105325","12","12","9","3","6","2.50"
"105375","15","15","14","1","9","2.50"
"105473","16","16","12","4","9","2.50"
"105518","15","15","12","3","9","2.50"
"105589","14","14","13","1","6","2.50"
"105594","18","18","15","3","13","2.50"
"105744","9","9","9","0","6","2.50"
"105752","15","15","14","1","12","2.50"
"105753","13","13","13","0","8","2.50"
"105813","19","19","18","1","14","2.50"
"105940","14","14","13","1","10","2.50"
"106007","12","12","11","1","8","2.50"
"106083","13","13","12","1","8","2.50"
"106086","7","7","5","2","2","2.50"
"106229","14","14","12","2","8","2.50"
"106270","7","7","6","1","4","2.50"
"106358","21","21","16","5","11","2.50"
"106422","8","8","8","0","6","2.50"
"106436","11","11","9","2","7","2.50"
"106514","14","14","13","1","8","2.50"
"106517","15","15","13","2","7","2.50"
"106526","20","20","20","0","14","2.50"
"106535","10","10","8","2","7","2.50"
"106541","14","14","14","0","9","2.50"
"106557","17","17","16","1","12","2.50"
"106583","16","16","15","1","10","2.50"
"106588","10","10","7","3","7","2.50"
"106606","10","10","10","0","5","2.50"
"106610","11","11","9","2","7","2.50"
"106640","10","10","10","0","5","2.50"
"106729","19","19","16","3","8","2.50"
"106740","7","7","6","1","5","2.50"
"106753","9","9","9","0","6","2.50"
"106765","11","11","10","1","9","2.50"
"106788","15","15","15","0","8","2.50"
"106833","14","14","12","2","7","2.50"
"106834","9","9","7","2","6","2.50"
"106850","13","13","13","0","6","2.50"
"106990","11","11","10","1","6","2.50"
"106997","11","11","9","2","6","2.50"
"107003","16","15","14","2","9","2.50"
"107018","11","11","11","0","9","2.50"
"107034","13","13","13","0","9","2.50"
"107081","17","17","16","1","14","2.50"
"107110","11","11","8","3","4","2.50"
"107181","16","16","13","3","8","2.50"
"107198","13","13","10","3","7","2.50"
"107230","14","14","12","2","9","2.50"
"107304","8","8","8","0","4","2.50"
"107317","12","12","10","2","6","2.50"
"107379","14","14","11","3","9","2.50"
"107408","11","11","9","2","6","2.50"
"107416","16","16","13","3","11","2.50"
"107563","10","10","9","1","7","2.50"
"107624","10","10","9","1","4","2.50"
"107646","8","8","8","0","7","2.50"
"107755","17","17","14","3","11","2.50"
"107782","13","13","13","0","7","2.50"
"107871","14","14","11","3","6","2.50"
"107911","8","8","6","2","4","2.50"
"107923","11","11","8","3","4","2.50"
"107948","10","10","10","0","6","2.50"
"107952","16","16","15","1","11","2.50"
"108146","14","14","11","3","8","2.50"
"108207","12","12","11","1","9","2.50"
"108215","14","14","13","1","5","2.50"
"108220","9","9","9","0","4","2.50"
"108289","17","17","17","0","13","2.50"
"108351","12","12","11","1","7","2.50"
"108359","11","11","9","2","5","2.50"
"108411","11","11","9","2","6","2.50"
"108437","10","10","8","2","6","2.50"
"108536","13","13","10","3","6","2.50"
"108565","12","12","9","3","5","2.50"
"108583","15","15","15","0","11","2.50"
"108608","8","8","8","0","5","2.50"
"108754","11","11","9","2","7","2.50"
"108820","20","20","20","0","14","2.50"
"108946","8","8","7","1","4","2.50"
"108974","11","11","10","1","9","2.50"
"108980","9","9","8","1","5","2.50"
"109036","14","14","11","3","6","2.50"
"109076","14","14","13","1","9","2.50"
"109131","12","12","12","0","9","2.50"
"109145","17","17","15","2","13","2.50"
"109150","16","16","14","2","10","2.50"
"109238","11","11","10","1","6","2.50"
"109353","16","16","14","2","9","2.50"
"109371","15","15","14","1","10","2.50"
"109488","14","14","13","1","10","2.50"
"109490","14","14","12","2","8","2.50"
"109531","12","12","11","1","6","2.50"
"109609","13","13","12","1","10","2.50"
"109621","11","11","10","1","7","2.50"
"109671","14","14","12","2","9","2.50"
"109695","7","7","6","1","6","2.50"
"109727","13","13","11","2","5","2.50"
"109753","11","11","8","3","3","2.50"
"109757","11","11","11","0","6","2.50"
"109792","17","17","16","1","10","2.50"
"109836","21","21","18","3","12","2.50"
"109852","8","8","8","0","4","2.50"
"109870","13","13","12","1","8","2.50"
"109877","15","15","13","2","10","2.50"
"109887","12","12","11","1","7","2.50"
"109931","10","10","9","1","5","2.50"
"109932","17","17","16","1","10","2.50"
"109952","12","12","11","1","6","2.50"
"109987","10","10","8","2","4","2.50"
"109989","14","14","11","3","6","2.50"
"110146","18","18","16","2","10","2.50"
"110160","16","16","15","1","10","2.50"
"110198","22","22","21","1","13","2.50"
"110209","13","13","12","1","6","2.50"
"110244","17","17","17","0","12","2.50"
"110246","12","12","11","1","5","2.50"
"110270","14","14","13","1","7","2.50"
"110338","17","17","17","0","11","2.50"
"110358","18","18","16","2","10","2.50"
"110405","6","6","6","0","2","2.50"
"110408","14","14","13","1","8","2.50"
"110450","12","12","12","0","10","2.50"
"110487","15","15","14","1","7","2.50"
"110551","13","13","13","0","9","2.50"
"110590","9","9","7","2","6","2.50"
"110640","15","15","13","2","10","2.50"
"110673","17","17","16","1","13","2.50"
"110680","14","14","14","0","10","2.50"
"110806","14","14","13","1","8","2.50"
"110893","12","12","12","0","8","2.50"
"110913","13","13","12","1","6","2.50"
"110940","13","13","13","0","10","2.50"
"110971","17","17","16","1","12","2.50"
"111100","15","15","13","2","10","2.50"
"111124","11","11","11","0","5","2.50"
"111127","16","16","12","4","8","2.50"
"111258","7","7","7","0","4","2.50"
"111280","14","14","14","0","8","2.50"
"111286","9","9","9","0","6","2.50"
"111287","17","17","16","1","11","2.50"
"111320","9","9","9","0","6","2.50"
"111359","14","14","12","2","5","2.50"
"111392","11","11","8","3","6","2.50"
"111431","14","14","13","1","6","2.50"
"111471","11","11","8","3","7","2.50"
"111504","16","16","15","1","8","2.50"
"111535","7","7","6","1","6","2.50"
"111539","12","12","9","3","5","2.50"
"111588","11","11","7","4","7","2.50"
"111602","7","7","6","1","5","2.50"
"111604","12","12","11","1","6","2.50"
"111619","17","17","13","4","9","2.50"
"111633","17","17","16","1","10","2.50"
"111658","13","13","12","1","10","2.50"
"111659","10","10","7","3","4","2.50"
"111713","9","9","8","1","6","2.50"
"111752","8","8","7","1","2","2.50"
"111871","12","12","9","3","4","2.50"
"111875","17","17","15","2","8","2.50"
"111931","13","13","11","2","7","2.50"
"111939","17","17","15","2","14","2.50"
"111967","14","14","13","1","11","2.50"
"112056","17","17","17","0","12","2.50"
"112073","19","19","14","5","8","2.50"
"112092","6","6","5","1","4","2.50"
"112097","5","5","5","0","3","2.50"
"112114","18","18","16","2","11","2.50"
"112233","11","11","10","1","4","2.50"
"112322","16","16","13","3","10","2.50"
"112459","14","14","12","2","7","2.50"
"112466","16","16","14","2","9","2.50"
"112468","13","13","13","0","11","2.50"
"112483","19","19","17","2","10","2.50"
"112550","12","12","10","2","5","2.50"
"112576","7","7","6","1","2","2.50"
"112595","15","15","14","1","7","2.50"
"112607","15","15","12","3","6","2.50"
"112649","15","15","11","4","7","2.50"
"112698","14","14","11","3","7","2.50"
"112746","13","13","12","1","9","2.50"
"112805","17","17","16","1","14","2.50"
"112819","16","16","14","2","8","2.50"
"112857","22","22","20","2","11","2.50"
"112891","18","18","15","3","12","2.50"
"112912","12","12","11","1","9","2.50"
"112936","26","26","20","6","9","2.50"
"112991","14","14","14","0","9","2.50"
"112994","17","17","16","1","11","2.50"
"113018","10","10","6","4","3","2.50"
"113095","13","13","9","4","5","2.50"
"113152","11","11","10","1","8","2.50"
"113163","21","21","18","3","8","2.50"
"113203","12","12","10","2","6","2.50"
"113204","15","15","13","2","11","2.50"
"113229","8","8","8","0","6","2.50"
"113300","9","9","9","0","8","2.50"
"113317","10","10","10","0","6","2.50"
"113320","14","14","13","1","4","2.50"
"113426","6","6","6","0","4","2.50"
"113456","18","18","16","2","14","2.50"
"113469","13","13","9","4","5","2.50"
"113498","9","9","8","1","7","2.50"
"113599","12","12","10","2","5","2.50"
"113644","18","18","17","1","10","2.50"
"113887","17","17","13","4","9","2.50"
"113920","16","16","13","3","7","2.50"
"113963","14","14","10","4","6","2.50"
"114012","12","12","11","1","8","2.50"
"114041","9","9","7","2","4","2.50"
"114103","8","8","7","1","4","2.50"
"114117","15","15","14","1","8","2.50"
"114199","12","12","9","3","6","2.50"
"114244","11","11","11","0","8","2.50"
"114250","16","16","15","1","13","2.50"
"114254","20","20","19","1","14","2.50"
"114259","15","15","13","2","10","2.50"
"114307","8","8","6","2","4","2.50"
"114321","13","13","13","0","9","2.50"
"114361","8","8","7","1","5","2.50"
"114372","10","10","4","6","2","2.50"
"114419","11","11","9","2","6","2.50"
"114450","20","20","18","2","13","2.50"
"114458","18","18","14","4","10","2.50"
"114546","9","9","9","0","8","2.50"
"114554","11","11","11","0","7","2.50"
"114588","13","13","12","1","8","2.50"
"114739","15","15","14","1","8","2.50"
"114774","15","15","14","1","8","2.50"
"114791","15","15","14","1","14","2.50"
"114794","13","13","10","3","8","2.50"
"114898","6","6","6","0","5","2.50"
"115034","7","7","6","1","2","2.50"
"115053","16","16","12","4","9","2.50"
"115108","11","11","10","1","5","2.50"
"115113","18","18","17","1","12","2.50"
"115117","10","10","10","0","7","2.50"
"115123","10","10","7","3","5","2.50"
"115182","15","15","12","3","8","2.50"
"115197","17","17","15","2","11","2.50"
"115243","10","10","10","0","7","2.50"
"115326","10","10","10","0","8","2.50"
"115328","11","11","10","1","7","2.50"
"115423","12","12","11","1","6","2.50"
"115445","13","13","10","3","5","2.50"
"115519","21","21","17","4","10","2.50"
"115539","7","7","7","0","5","2.50"
"115552","12","12","10","2","4","2.50"
"115559","17","17","16","1","6","2.50"
"115625","13","13","13","0","9","2.50"
"115629","12","12","12","0","6","2.50"
"115719","11","11","11","0","4","2.50"
"115752","19","19","17","2","11","2.50"
"115787","9","9","8","1","4","2.50"
"115865","9","9","6","3","4","2.50"
"116099","12","12","11","1","6","2.50"
"116101","14","14","13","1","10","2.50"
"116152","10","10","10","0","6","2.50"
"116159","15","15","14","1","6","2.50"
"116163","15","15","15","0","11","2.50"
"116172","17","17","15","2","11","2.50"
"116234","16","16","12","4","10","2.50"
"116240","19","19","19","0","14","2.50"
"116280","10","10","8","2","5","2.50"
"116348","15","15","13","2","10","2.50"
"116354","13","13","10","3","6","2.50"
"116475","9","9","9","0","9","2.50"
"116562","10","10","10","0","7","2.50"
"116616","8","8","7","1","2","2.50"
"116654","14","14","12","2","7","2.50"
"116693","14","14","13","1","8","2.50"
"116804","20","20","18","2","13","2.50"
"116891","15","15","13","2","10","2.50"
"116905","17","17","16","1","9","2.50"
"116929","12","12","11","1","4","2.50"
"116947","12","12","10","2","8","2.50"
"117003","12","12","12","0","9","2.50"
"117040","9","9","8","1","6","2.50"
"117079","15","15","12","3","11","2.50"
"117115","8","8","8","0","4","2.50"
"117129","14","14","10","4","6","2.50"
"117130","11","11","9","2","5","2.50"
"117156","18","18","15","3","9","2.50"
"117164","4","4","4","0","2","2.50"
"117235","14","14","12","2","8","2.50"
"117238","11","11","9","2","4","2.50"
"117329","6","6","5","1","2","2.50"
"117360","14","14","12","2","7","2.50"
"117370","8","8","7","1","4","2.50"
"117375","10","10","10","0","4","2.50"
"117509","11","11","9","2","6","2.50"
"117542","13","13","11","2","7","2.50"
"117545","14","14","14","0","12","2.50"
"117561","18","18","17","1","11","2.50"
"117571","14","14","14","0","9","2.50"
"105825","27","27","26","1","22","2.49"
"110177","19","19","14","5","13","2.49"
"113413","21","21","18","3","13","2.49"
"100481","21","21","21","0","15","2.48"
"100772","15","15","13","2","10","2.48"
"101166","17","17","15","2","10","2.48"
"101918","20","20","19","1","13","2.48"
"102144","14","14","13","1","10","2.48"
"102180","11","11","9","2","9","2.48"
"102681","23","23","23","0","16","2.48"
"102712","18","18","18","0","15","2.48"
"102726","18","18","17","1","11","2.48"
"103117","16","16","14","2","11","2.48"
"103691","15","15","14","1","12","2.48"
"105616","11","11","11","0","10","2.48"
"106049","11","11","11","0","9","2.48"
"106770","19","19","15","4","9","2.48"
"108940","21","21","19","2","12","2.48"
"109830","13","13","13","0","9","2.48"
"109939","17","17","16","1","12","2.48"
"110959","19","19","16","3","12","2.48"
"111405","19","19","18","1","17","2.48"
"112707","22","21","20","2","16","2.48"
"113514","13","13","13","0","9","2.48"
"113556","19","19","17","2","13","2.48"
"114506","19","19","17","2","11","2.48"
"114890","19","19","19","0","15","2.48"
"115186","16","16","15","1","11","2.48"
"115357","16","16","15","1","11","2.48"
"115581","15","15","14","1","10","2.48"
"116608","17","17","15","2","13","2.48"
"116826","21","21","19","2","14","2.48"
"116907","17","17","16","1","9","2.48"
"117459","15","15","12","3","11","2.48"
"100139","13","13","11","2","7","2.47"
"101037","15","15","15","0","11","2.47"
"101115","15","15","13","2","8","2.47"
"101269","11","11","10","1","9","2.47"
"102814","14","14","13","1","9","2.47"
"103136","11","11","8","3","7","2.47"
"103457","14","14","11","3","7","2.47"
"103530","14","14","13","1","8","2.47"
"103684","11","11","11","0","9","2.47"
"105109","16","16","15","1","12","2.47"
"105554","16","16","15","1","13","2.47"
"105795","12","12","11","1","7","2.47"
"106066","16","16","13","3","9","2.47"
"106154","14","14","13","1","9","2.47"
"106425","13","13","12","1","8","2.47"
"107057","10","10","10","0","9","2.47"
"107172","12","12","12","0","7","2.47"
"109303","23","23","21","2","17","2.47"
"109556","16","16","14","2","12","2.47"
"109565","25","25","21","4","14","2.47"
"109587","25","25","22","3","13","2.47"
"109894","12","12","10","2","7","2.47"
"110350","15","15","15","0","10","2.47"
"110535","14","14","12","2","7","2.47"
"110963","10","10","9","1","9","2.47"
"111606","11","11","9","2","7","2.47"
"111859","20","20","20","0","14","2.47"
"112638","15","15","15","0","9","2.47"
"113221","16","16","15","1","10","2.47"
"114747","10","10","10","0","8","2.47"
"114868","19","19","19","0","12","2.47"
"115157","12","12","11","1","7","2.47"
"115158","12","12","10","2","7","2.47"
"115682","18","18","18","0","15","2.47"
"115987","15","15","14","1","13","2.47"
"117463","17","17","15","2","10","2.47"
"117557","16","16","16","0","11","2.47"
"100565","16","16","14","2","10","2.46"
"101691","18","18","17","1","10","2.46"
"103295","14","14","13","1","9","2.46"
"103339","12","12","10","2","8","2.46"
"104129","13","13","12","1","7","2.46"
"104560","12","12","12","0","7","2.46"
"105061","13","13","12","1","10","2.46"
"105769","22","22","20","2","10","2.46"
"106752","22","22","20","2","12","2.46"
"106890","19","19","17","2","12","2.46"
"107529","13","13","13","0","10","2.46"
"107650","10","10","8","2","8","2.46"
"108320","15","15","14","1","11","2.46"
"108483","11","11","11","0","7","2.46"
"108814","19","19","17","2","11","2.46"
"109007","16","16","13","3","13","2.46"
"110650","17","17","16","1","13","2.46"
"110861","13","13","12","1","7","2.46"
"111650","14","14","13","1","8","2.46"
"112480","19","19","18","1","11","2.46"
"113039","16","16","14","2","12","2.46"
"113245","13","13","13","0","12","2.46"
"113546","22","22","22","0","13","2.46"
"114099","17","17","15","2","12","2.46"
"114384","17","17","15","2","13","2.46"
"114480","19","18","17","2","15","2.46"
"114871","15","15","13","2","8","2.46"
"114882","18","18","17","1","13","2.46"
"115505","18","18","15","3","11","2.46"
"116031","18","18","15","3","12","2.46"
"116551","15","15","15","0","7","2.46"
"117519","19","19","15","4","12","2.46"
"100006","15","15","11","4","11","2.45"
"101075","21","21","20","1","15","2.45"
"101648","14","14","12","2","9","2.45"
"101771","11","11","10","1","9","2.45"
"102609","14","14","13","1","9","2.45"
"102691","12","12","11","1","8","2.45"
"103898","12","12","10","2","8","2.45"
"104313","22","22","18","4","11","2.45"
"104602","14","14","14","0","12","2.45"
"104850","15","15","15","0","12","2.45"
"105360","14","14","13","1","9","2.45"
"105481","14","14","14","0","11","2.45"
"105601","10","10","10","0","9","2.45"
"105967","17","17","16","1","13","2.45"
"106300","15","15","13","2","10","2.45"
"106467","13","13","12","1","10","2.45"
"106748","14","14","13","1","8","2.45"
"106972","25","25","18","7","14","2.45"
"108367","19","19","19","0","16","2.45"
"109162","13","13","11","2","9","2.45"
"109990","13","13","13","0","8","2.45"
"110167","18","18","14","4","10","2.45"
"110424","20","20","17","3","12","2.45"
"110719","14","14","12","2","9","2.45"
"110767","11","11","11","0","8","2.45"
"111095","10","10","10","0","8","2.45"
"111199","17","17","16","1","13","2.45"
"111228","10","10","10","0","8","2.45"
"111310","16","16","14","2","11","2.45"
"111773","12","12","11","1","9","2.45"
"112053","14","14","13","1","9","2.45"
"112175","15","15","15","0","15","2.45"
"112273","21","21","20","1","15","2.45"
"112890","22","22","21","1","14","2.45"
"112948","16","16","12","4","8","2.45"
"113261","20","20","17","3","11","2.45"
"113521","16","16","13","3","9","2.45"
"113821","18","18","16","2","10","2.45"
"114036","16","16","15","1","12","2.45"
"114445","15","15","14","1","12","2.45"
"114502","15","15","14","1","10","2.45"
"115059","16","16","13","3","8","2.45"
"116010","12","12","12","0","8","2.45"
"116148","16","16","16","0","12","2.45"
"116465","10","10","10","0","10","2.45"
"116662","19","19","17","2","11","2.45"
"116715","15","15","14","1","10","2.45"
"116885","18","18","18","0","14","2.45"
"117241","18","18","16","2","12","2.45"
"117409","17","17","16","1","11","2.45"
"100162","15","15","13","2","10","2.44"
"100405","14","14","13","1","12","2.44"
"101021","19","19","18","1","11","2.44"
"101025","17","17","16","1","10","2.44"
"101454","19","19","19","0","15","2.44"
"101639","12","12","12","0","9","2.44"
"101988","13","13","11","2","5","2.44"
"102246","15","15","13","2","12","2.44"
"102274","16","16","14","2","10","2.44"
"102376","17","17","16","1","11","2.44"
"102526","16","16","14","2","10","2.44"
"102598","23","23","22","1","14","2.44"
"102703","12","12","11","1","10","2.44"
"102840","19","19","16","3","12","2.44"
"103441","8","8","8","0","7","2.44"
"103765","12","12","10","2","10","2.44"
"104184","9","9","8","1","5","2.44"
"104771","13","13","12","1","8","2.44"
"105307","10","10","8","2","7","2.44"
"106010","18","18","16","2","13","2.44"
"106630","15","15","13","2","10","2.44"
"106679","17","17","15","2","11","2.44"
"107437","16","16","14","2","8","2.44"
"108181","16","16","13","3","12","2.44"
"108768","18","18","14","4","12","2.44"
"109832","18","17","15","3","9","2.44"
"110031","14","14","14","0","11","2.44"
"110072","13","13","12","1","10","2.44"
"110076","17","17","14","3","12","2.44"
"111224","17","17","17","0","13","2.44"
"111558","17","17","13","4","10","2.44"
"111778","21","21","20","1","15","2.44"
"111949","16","16","14","2","10","2.44"
"112453","15","15","15","0","14","2.44"
"112930","22","22","21","1","17","2.44"
"113683","12","12","12","0","11","2.44"
"113722","16","16","16","0","12","2.44"
"113805","17","17","16","1","14","2.44"
"114504","22","22","19","3","14","2.44"
"114574","12","12","12","0","9","2.44"
"114967","20","20","19","1","15","2.44"
"114972","22","22","20","2","16","2.44"
"115060","16","16","15","1","11","2.44"
"115286","16","16","16","0","13","2.44"
"116064","21","21","18","3","14","2.44"
"116210","17","17","17","0","12","2.44"
"116246","18","18","15","3","10","2.44"
"116839","19","18","15","4","9","2.44"
"117128","16","16","14","2","11","2.44"
"117176","12","12","11","1","9","2.44"
"117320","12","12","11","1","9","2.44"
"117604","12","12","11","1","9","2.44"
"100057","13","13","11","2","9","2.43"
"100398","12","11","12","0","10","2.43"
"100505","17","17","15","2","9","2.43"
"100658","19","19","17","2","11","2.43"
"101002","17","17","14","3","11","2.43"
"101124","8","8","8","0","7","2.43"
"101409","13","13","11","2","9","2.43"
"101438","17","17","15","2","12","2.43"
"101522","14","14","12","2","9","2.43"
"101728","12","12","11","1","8","2.43"
"101917","11","11","8","3","7","2.43"
"102009","17","17","15","2","12","2.43"
"102111","12","12","12","0","7","2.43"
"102135","14","14","13","1","9","2.43"
"102162","15","15","13","2","10","2.43"
"102287","11","11","10","1","8","2.43"
"102446","19","19","17","2","10","2.43"
"102621","14","14","12","2","9","2.43"
"102813","18","18","16","2","12","2.43"
"103121","13","13","10","3","9","2.43"
"103257","10","10","9","1","7","2.43"
"103294","18","18","16","2","9","2.43"
"103338","15","15","12","3","9","2.43"
"103695","13","13","12","1","8","2.43"
"103711","13","13","12","1","9","2.43"
"103740","19","19","16","3","8","2.43"
"103839","15","15","13","2","8","2.43"
"103854","14","14","13","1","9","2.43"
"104004","14","14","14","0","9","2.43"
"104030","19","19","18","1","12","2.43"
"104674","16","16","15","1","10","2.43"
"104814","14","14","14","0","11","2.43"
"105053","11","11","9","2","8","2.43"
"105365","12","12","12","0","9","2.43"
"105369","21","21","20","1","13","2.43"
"105922","15","15","12","3","9","2.43"
"106095","21","21","20","1","9","2.43"
"106387","14","14","14","0","11","2.43"
"106528","15","15","14","1","10","2.43"
"106901","11","11","10","1","8","2.43"
"107136","13","13","13","0","9","2.43"
"107192","14","14","12","2","9","2.43"
"107393","14","14","11","3","8","2.43"
"108086","15","15","13","2","11","2.43"
"108395","15","15","13","2","9","2.43"
"108403","16","16","13","3","10","2.43"
"109331","19","19","19","0","15","2.43"
"110221","10","10","8","2","7","2.43"
"110240","15","15","14","1","9","2.43"
"110403","13","13","11","2","8","2.43"
"110530","14","14","13","1","9","2.43"
"110931","15","15","13","2","8","2.43"
"111151","15","15","15","0","8","2.43"
"112106","14","13","14","0","10","2.43"
"112524","16","16","14","2","8","2.43"
"112740","20","20","18","2","12","2.43"
"112750","11","11","11","0","9","2.43"
"112883","19","19","18","1","12","2.43"
"113032","17","17","15","2","10","2.43"
"113118","16","16","15","1","9","2.43"
"113448","13","13","13","0","8","2.43"
"113506","13","13","13","0","10","2.43"
"114248","20","20","18","2","14","2.43"
"114657","17","17","16","1","9","2.43"
"114693","11","11","11","0","9","2.43"
"115934","10","10","10","0","7","2.43"
"116144","12","12","12","0","11","2.43"
"116609","15","15","14","1","10","2.43"
"116675","21","21","19","2","13","2.43"
"117082","14","14","13","1","9","2.43"
"117287","22","22","20","2","11","2.43"
"100079","13","13","13","0","9","2.42"
"100313","15","15","9","6","7","2.42"
"100367","11","11","11","0","9","2.42"
"100552","13","13","12","1","8","2.42"
"100930","11","11","10","1","9","2.42"
"101066","11","11","11","0","7","2.42"
"101111","11","11","10","1","7","2.42"
"101164","14","14","12","2","7","2.42"
"101283","16","16","11","5","8","2.42"
"101322","10","10","10","0","7","2.42"
"101748","10","10","9","1","7","2.42"
"101843","17","17","16","1","12","2.42"
"102003","16","16","16","0","14","2.42"
"102134","13","13","11","2","7","2.42"
"102178","18","18","17","1","10","2.42"
"102771","19","19","16","3","9","2.42"
"102827","16","16","15","1","9","2.42"
"102993","16","16","14","2","8","2.42"
"102994","13","13","13","0","8","2.42"
"103028","21","21","19","2","13","2.42"
"103167","14","14","13","1","8","2.42"
"103380","17","17","15","2","9","2.42"
"103534","14","14","12","2","11","2.42"
"103578","14","14","12","2","8","2.42"
"103633","16","16","13","3","10","2.42"
"103747","14","14","13","1","10","2.42"
"103866","15","15","14","1","10","2.42"
"104079","11","11","11","0","8","2.42"
"104326","14","14","14","0","9","2.42"
"104547","16","16","14","2","12","2.42"
"104625","11","11","10","1","7","2.42"
"104758","19","19","18","1","13","2.42"
"104855","14","14","14","0","13","2.42"
"104892","14","14","14","0","8","2.42"
"104945","12","12","11","1","7","2.42"
"105222","13","13","13","0","7","2.42"
"105423","14","14","13","1","8","2.42"
"106059","21","21","19","2","15","2.42"
"106250","16","16","16","0","13","2.42"
"106339","17","16","17","0","14","2.42"
"106435","15","15","13","2","11","2.42"
"106532","11","11","10","1","7","2.42"
"106599","16","16","16","0","9","2.42"
"106641","19","19","18","1","10","2.42"
"107101","10","10","9","1","8","2.42"
"107104","13","12","12","1","9","2.42"
"107253","14","14","13","1","11","2.42"
"107303","13","13","12","1","8","2.42"
"107836","16","16","14","2","9","2.42"
"107898","14","14","11","3","8","2.42"
"108260","14","14","14","0","7","2.42"
"108350","8","8","8","0","7","2.42"
"108830","13","13","12","1","8","2.42"
"108981","15","15","13","2","7","2.42"
"109239","12","12","10","2","6","2.42"
"109361","17","17","14","3","12","2.42"
"109489","11","11","10","1","8","2.42"
"109506","26","26","24","2","14","2.42"
"109590","13","12","13","0","7","2.42"
"109736","9","9","9","0","7","2.42"
"109854","16","16","15","1","10","2.42"
"110069","15","15","14","1","8","2.42"
"110083","16","16","15","1","8","2.42"
"110324","12","12","12","0","11","2.42"
"110493","15","15","14","1","7","2.42"
"110608","13","13","10","3","8","2.42"
"110874","13","13","11","2","8","2.42"
"111017","16","16","13","3","8","2.42"
"111187","15","15","11","4","10","2.42"
"111377","16","16","13","3","11","2.42"
"111441","16","16","14","2","10","2.42"
"111969","8","8","7","1","6","2.42"
"112035","13","13","12","1","7","2.42"
"112043","14","14","12","2","7","2.42"
"112254","10","10","7","3","7","2.42"
"112647","18","18","15","3","14","2.42"
"112734","11","11","10","1","7","2.42"
"112817","16","16","13","3","8","2.42"
"112858","11","11","11","0","9","2.42"
"113038","14","14","12","2","7","2.42"
"113086","16","16","16","0","14","2.42"
"113333","19","19","19","0","11","2.42"
"113400","12","12","9","3","6","2.42"
"114326","13","13","11","2","10","2.42"
"114638","14","14","13","1","9","2.42"
"114763","17","17","17","0","11","2.42"
"114866","17","17","15","2","12","2.42"
"115068","12","12","11","1","8","2.42"
"115192","12","12","11","1","7","2.42"
"115194","19","19","19","0","13","2.42"
"115318","12","12","12","0","8","2.42"
"115341","18","18","16","2","9","2.42"
"115369","15","15","14","1","10","2.42"
"115419","10","10","9","1","8","2.42"
"115424","26","26","24","2","13","2.42"
"115550","16","16","15","1","8","2.42"
"115626","17","17","14","3","9","2.42"
"115871","12","12","9","3","7","2.42"
"116435","18","18","16","2","13","2.42"
"116590","12","12","11","1","8","2.42"
"116634","8","8","8","0","6","2.42"
"116823","9","9","9","0","6","2.42"
"116928","13","13","11","2","10","2.42"
"106671","22","22","18","4","14","2.41"
"109861","17","17","17","0","14","2.41"
"112456","18","18","15","3","12","2.41"
"113557","20","20","19","1","15","2.41"
"116996","18","18","18","0","12","2.41"
"117299","19","19","18","1","14","2.41"
"100120","14","14","14","0","9","2.40"
"100156","14","14","14","0","12","2.40"
"100253","15","15","14","1","8","2.40"
"100651","10","10","6","4","6","2.40"
"100671","19","19","19","0","15","2.40"
"101042","16","16","15","1","10","2.40"
"101049","12","12","9","3","7","2.40"
"101110","12","12","10","2","7","2.40"
"101188","7","7","6","1","6","2.40"
"101628","13","12","12","1","11","2.40"
"101851","12","12","12","0","9","2.40"
"101860","10","10","9","1","5","2.40"
"101882","10","10","10","0","7","2.40"
"101909","13","13","11","2","6","2.40"
"101932","17","17","15","2","12","2.40"
"102037","14","14","12","2","8","2.40"
"102097","15","15","12","3","7","2.40"
"102210","11","11","10","1","5","2.40"
"102351","20","20","19","1","15","2.40"
"102632","13","13","12","1","9","2.40"
"102918","13","13","12","1","6","2.40"
"102949","18","18","16","2","12","2.40"
"103153","8","8","7","1","6","2.40"
"103211","10","10","9","1","7","2.40"
"103301","12","12","11","1","5","2.40"
"103376","15","15","15","0","9","2.40"
"103382","14","14","14","0","7","2.40"
"103402","10","10","8","2","6","2.40"
"103451","9","9","7","2","5","2.40"
"103748","17","17","14","3","9","2.40"
"103785","19","19","16","3","11","2.40"
"103837","10","10","8","2","6","2.40"
"103942","17","17","13","4","11","2.40"
"104162","16","16","15","1","8","2.40"
"104289","16","16","14","2","12","2.40"
"104425","16","16","12","4","8","2.40"
"104446","14","14","12","2","7","2.40"
"104581","11","11","10","1","6","2.40"
"104709","10","10","10","0","5","2.40"
"104730","10","10","8","2","7","2.40"
"104992","14","14","13","1","8","2.40"
"105011","14","14","12","2","8","2.40"
"105490","12","12","10","2","5","2.40"
"105545","12","12","10","2","7","2.40"
"105553","17","17","12","5","5","2.40"
"105641","13","13","8","5","5","2.40"
"105895","16","16","12","4","7","2.40"
"105916","12","12","10","2","7","2.40"
"106676","17","17","15","2","9","2.40"
"106681","13","13","13","0","7","2.40"
"106987","10","10","9","1","6","2.40"
"107076","8","8","8","0","6","2.40"
"107096","12","12","9","3","5","2.40"
"107116","16","16","14","2","9","2.40"
"107158","16","16","11","5","6","2.40"
"107170","15","15","13","2","9","2.40"
"107196","15","15","13","2","8","2.40"
"107247","7","7","7","0","5","2.40"
"107366","22","22","19","3","11","2.40"
"107368","14","14","11","3","7","2.40"
"107473","16","16","13","3","9","2.40"
"107474","10","10","9","1","7","2.40"
"107497","17","17","16","1","12","2.40"
"107751","14","14","12","2","7","2.40"
"107762","14","14","12","2","6","2.40"
"107926","14","14","13","1","8","2.40"
"108054","16","16","16","0","13","2.40"
"108253","12","12","10","2","5","2.40"
"108279","14","14","11","3","7","2.40"
"108386","7","7","6","1","5","2.40"
"108465","16","16","16","0","14","2.40"
"108558","12","12","9","3","6","2.40"
"108797","9","9","9","0","7","2.40"
"108844","14","14","14","0","8","2.40"
"108918","11","11","11","0","7","2.40"
"109127","11","11","10","1","5","2.40"
"109186","14","14","12","2","9","2.40"
"109223","13","13","11","2","6","2.40"
"109496","15","15","11","4","5","2.40"
"109713","13","13","11","2","8","2.40"
"109755","11","11","11","0","6","2.40"
"109768","15","15","14","1","12","2.40"
"109818","13","13","11","2","7","2.40"
"109822","12","12","11","1","7","2.40"
"109909","10","10","8","2","6","2.40"
"109963","10","10","9","1","6","2.40"
"110018","14","14","13","1","7","2.40"
"110135","12","12","10","2","6","2.40"
"110181","10","10","9","1","7","2.40"
"110249","18","18","16","2","12","2.40"
"110325","8","8","7","1","6","2.40"
"110562","9","9","9","0","5","2.40"
"110669","9","9","8","1","6","2.40"
"110685","12","12","11","1","6","2.40"
"110734","11","11","10","1","9","2.40"
"110747","12","12","10","2","7","2.40"
"110810","11","11","11","0","8","2.40"
"111107","13","13","13","0","7","2.40"
"111128","17","17","15","2","12","2.40"
"111140","13","13","13","0","6","2.40"
"111196","19","19","16","3","12","2.40"
"111297","11","11","11","0","8","2.40"
"111510","9","9","8","1","7","2.40"
"111541","16","16","15","1","11","2.40"
"111790","9","9","8","1","6","2.40"
"112000","17","17","15","2","13","2.40"
"112084","9","9","9","0","6","2.40"
"112168","13","13","12","1","7","2.40"
"112192","12","12","10","2","7","2.40"
"112295","15","15","14","1","7","2.40"
"112384","14","14","13","1","7","2.40"
"112534","9","9","7","2","6","2.40"
"112568","13","13","12","1","7","2.40"
"113022","19","19","15","4","8","2.40"
"113270","15","15","14","1","12","2.40"
"113362","13","13","11","2","9","2.40"
"113432","13","13","13","0","6","2.40"
"113453","14","14","12","2","7","2.40"
"113687","12","12","12","0","7","2.40"
"114010","16","16","14","2","10","2.40"
"114137","9","9","8","1","6","2.40"
"114299","14","14","9","5","5","2.40"
"114413","15","15","12","3","5","2.40"
"114428","17","17","17","0","9","2.40"
"114463","17","17","15","2","11","2.40"
"114616","12","12","10","2","5","2.40"
"114625","16","16","15","1","12","2.40"
"114872","12","12","11","1","10","2.40"
"115031","10","10","10","0","7","2.40"
"115082","9","9","9","0","7","2.40"
"115372","10","10","9","1","6","2.40"
"115387","13","13","12","1","7","2.40"
"115690","12","12","10","2","7","2.40"
"115824","19","19","18","1","10","2.40"
"116024","13","13","13","0","8","2.40"
"116286","25","25","17","8","14","2.40"
"116754","14","14","14","0","5","2.40"
"117048","15","15","15","0","11","2.40"
"117275","16","16","14","2","10","2.40"
"117405","10","10","9","1","6","2.40"
"117502","11","11","11","0","8","2.40"
"101380","19","19","16","3","11","2.39"
"101654","15","15","15","0","11","2.39"
"102177","24","24","21","3","13","2.39"
"104444","14","14","13","1","8","2.39"
"105525","16","16","16","0","13","2.39"
"105626","11","11","11","0","8","2.39"
"106293","18","18","17","1","14","2.39"
"106690","12","12","12","0","8","2.39"
"107179","21","21","21","0","12","2.39"
"107840","15","15","13","2","9","2.39"
"108147","11","11","11","0","10","2.39"
"108178","20","20","14","6","11","2.39"
"108417","21","21","20","1","9","2.39"
"109208","16","16","14","2","8","2.39"
"109345","9","9","9","0","8","2.39"
"109504","21","21","19","2","16","2.39"
"109693","16","16","14","2","8","2.39"
"110097","15","15","14","1","11","2.39"
"110667","18","18","17","1","15","2.39"
"111223","19","19","17","2","12","2.39"
"112235","13","13","12","1","10","2.39"
"113303","20","20","16","4","11","2.39"
"113359","18","18","17","1","11","2.39"
"115344","18","18","17","1","11","2.39"
"115508","11","11","10","1","8","2.39"
"115655","12","12","12","0","11","2.39"
"115681","16","16","15","1","11","2.39"
"115742","18","18","17","1","13","2.39"
"116029","18","18","15","3","9","2.39"
"116125","15","15","13","2","13","2.39"
"116153","20","20","17","3","11","2.39"
"116224","14","14","13","1","6","2.39"
"116783","10","10","10","0","10","2.39"
"116935","17","17","13","4","10","2.39"
"117592","16","16","14","2","11","2.39"
"100016","15","15","14","1","11","2.38"
"100342","12","12","12","0","9","2.38"
"100874","8","8","6","2","5","2.38"
"100919","14","14","14","0","11","2.38"
"100943","22","22","22","0","14","2.38"
"101244","14","14","14","0","12","2.38"
"101284","17","17","15","2","10","2.38"
"101321","15","15","14","1","10","2.38"
"101834","11","11","11","0","7","2.38"
"101937","21","21","20","1","13","2.38"
"102362","15","15","14","1","7","2.38"
"102401","18","17","18","0","14","2.38"
"102406","15","15","11","4","8","2.38"
"102495","11","11","7","4","6","2.38"
"103259","16","16","15","1","13","2.38"
"103595","13","13","13","0","7","2.38"
"103615","21","21","18","3","8","2.38"
"103640","22","22","17","5","16","2.38"
"103659","6","6","6","0","5","2.38"
"103868","14","14","14","0","8","2.38"
"104086","16","16","14","2","11","2.38"
"104247","19","19","18","1","10","2.38"
"104885","10","10","10","0","5","2.38"
"104955","12","12","12","0","7","2.38"
"105009","17","17","15","2","10","2.38"
"105083","12","12","12","0","10","2.38"
"105216","8","8","6","2","5","2.38"
"105871","11","11","11","0","8","2.38"
"105917","14","14","13","1","9","2.38"
"106019","10","10","10","0","5","2.38"
"106119","8","8","7","1","6","2.38"
"106215","12","12","9","3","5","2.38"
"106268","12","12","11","1","11","2.38"
"106352","11","11","11","0","8","2.38"
"106689","11","11","10","1","7","2.38"
"106880","11","11","11","0","7","2.38"
"106962","12","12","12","0","8","2.38"
"107369","13","13","10","3","7","2.38"
"107496","10","10","9","1","5","2.38"
"107654","14","14","12","2","11","2.38"
"107859","18","18","16","2","11","2.38"
"107970","6","6","5","1","5","2.38"
"108166","20","20","17","3","11","2.38"
"108616","13","13","13","0","6","2.38"
"108727","16","16","14","2","10","2.38"
"108741","12","12","10","2","5","2.38"
"109021","20","20","18","2","12","2.38"
"109037","19","19","19","0","10","2.38"
"109113","20","20","18","2","14","2.38"
"109126","7","7","6","1","5","2.38"
"109449","13","13","12","1","9","2.38"
"109789","12","12","11","1","9","2.38"
"110410","16","16","13","3","7","2.38"
"110462","11","11","10","1","6","2.38"
"111182","12","12","10","2","7","2.38"
"111340","12","12","10","2","5","2.38"
"111369","16","16","16","0","13","2.38"
"111520","14","14","13","1","5","2.38"
"111780","17","17","17","0","10","2.38"
"111838","11","11","10","1","7","2.38"
"111924","13","13","12","1","10","2.38"
"112005","14","14","9","5","7","2.38"
"112047","8","8","8","0","5","2.38"
"112371","13","13","12","1","10","2.38"
"112436","15","15","15","0","10","2.38"
"112624","11","11","10","1","9","2.38"
"112728","16","16","16","0","13","2.38"
"112938","10","10","9","1","7","2.38"
"112958","14","14","13","1","9","2.38"
"113026","8","8","8","0","6","2.38"
"113040","12","12","12","0","5","2.38"
"113259","15","15","14","1","11","2.38"
"113272","18","18","18","0","10","2.38"
"113376","18","18","15","3","11","2.38"
"113457","11","11","10","1","8","2.38"
"113554","6","6","6","0","5","2.38"
"113698","12","12","11","1","6","2.38"
"113782","14","14","13","1","10","2.38"
"113890","9","9","7","2","5","2.38"
"113947","11","11","10","1","5","2.38"
"114266","17","17","17","0","10","2.38"
"114732","8","8","7","1","5","2.38"
"114959","19","19","17","2","13","2.38"
"115278","8","8","7","1","5","2.38"
"115495","10","10","8","2","5","2.38"
"115678","17","16","17","0","9","2.38"
"115846","12","12","8","4","7","2.38"
"115886","8","8","6","2","5","2.38"
"115899","21","21","21","0","17","2.38"
"115943","16","16","15","1","12","2.38"
"116019","12","12","12","0","8","2.38"
"116037","13","13","11","2","5","2.38"
"116098","12","12","11","1","7","2.38"
"116306","15","15","12","3","8","2.38"
"116346","13","13","12","1","6","2.38"
"116473","17","16","14","3","6","2.38"
"116961","10","10","9","1","5","2.38"
"117013","9","9","9","0","5","2.38"
"117062","10","10","9","1","5","2.38"
"117136","17","17","16","1","14","2.38"
"117280","9","9","9","0","6","2.38"
"102967","14","14","12","2","11","2.37"
"103108","19","19","19","0","11","2.37"
"104028","14","14","10","4","9","2.37"
"105453","19","19","17","2","13","2.37"
"107221","12","12","10","2","8","2.37"
"107292","17","17","16","1","11","2.37"
"108028","15","15","15","0","14","2.37"
"109318","19","19","17","2","12","2.37"
"111062","15","15","13","2","10","2.37"
"111562","19","19","16","3","9","2.37"
"112461","17","17","14","3","11","2.37"
"113011","24","24","23","1","16","2.37"
"113323","20","20","16","4","13","2.37"
"113350","18","18","17","1","13","2.37"
"113909","13","13","13","0","8","2.37"
"113941","20","20","17","3","12","2.37"
"115453","14","14","13","1","8","2.37"
"115587","17","17","15","2","13","2.37"
"115896","18","18","16","2","10","2.37"
"116326","19","19","15","4","11","2.37"
"116848","18","18","17","1","14","2.37"
"100032","19","19","16","3","10","2.36"
"100236","13","13","12","1","10","2.36"
"100247","15","15","14","1","10","2.36"
"100347","14","14","12","2","9","2.36"
"100446","15","14","15","0","9","2.36"
"100447","14","14","12","2","10","2.36"
"100750","10","10","9","1","8","2.36"
"100799","15","15","14","1","10","2.36"
"101575","14","14","14","0","9","2.36"
"101861","12","12","10","2","8","2.36"
"102165","12","12","12","0","10","2.36"
"102312","13","13","12","1","8","2.36"
"102355","18","18","16","2","9","2.36"
"103460","14","14","13","1","8","2.36"
"103686","19","19","17","2","15","2.36"
"103897","20","20","16","4","10","2.36"
"104021","20","20","17","3","13","2.36"
"104297","18","18","13","5","9","2.36"
"104677","13","13","11","2","8","2.36"
"105042","18","18","16","2","10","2.36"
"105102","18","18","16","2","10","2.36"
"105259","15","15","14","1","10","2.36"
"105422","13","13","12","1","11","2.36"
"106804","19","19","14","5","10","2.36"
"107747","14","14","13","1","11","2.36"
"107974","14","14","13","1","10","2.36"
"108184","12","12","10","2","9","2.36"
"108375","14","14","11","3","10","2.36"
"108435","14","14","13","1","10","2.36"
"108732","13","13","13","0","9","2.36"
"108967","23","23","19","4","12","2.36"
"110119","19","19","16","3","10","2.36"
"110954","19","19","17","2","11","2.36"
"111227","13","13","11","2","8","2.36"
"111415","13","13","12","1","9","2.36"
"111688","11","11","11","0","9","2.36"
"111812","15","15","15","0","11","2.36"
"112055","17","17","16","1","10","2.36"
"112164","16","16","15","1","13","2.36"
"112240","17","17","14","3","9","2.36"
"112597","15","15","12","3","9","2.36"
"112713","14","14","11","3","9","2.36"
"113009","14","14","14","0","8","2.36"
"113734","10","10","10","0","9","2.36"
"114283","15","15","14","1","11","2.36"
"114294","15","15","13","2","12","2.36"
"114352","18","18","13","5","8","2.36"
"114454","18","18","18","0","12","2.36"
"114617","22","22","19","3","13","2.36"
"114997","18","18","17","1","13","2.36"
"115077","15","15","15","0","10","2.36"
"115375","17","17","16","1","9","2.36"
"116030","13","13","13","0","9","2.36"
"116182","14","14","13","1","10","2.36"
"116228","18","18","18","0","17","2.36"
"116400","13","13","12","1","9","2.36"
"117180","12","12","11","1","9","2.36"
"117289","21","21","20","1","16","2.36"
"117298","14","14","14","0","11","2.36"
"117593","15","15","14","1","10","2.36"
"117618","12","12","11","1","8","2.36"
"104831","12","12","11","1","10","2.35"
"105841","24","24","22","2","14","2.35"
"108587","18","18","15","3","12","2.35"
"108663","22","21","22","0","15","2.35"
"109458","15","15","13","2","11","2.35"
"112689","18","18","15","3","12","2.35"
"112833","13","13","12","1","8","2.35"
"113251","15","15","15","0","11","2.35"
"114293","17","17","14","3","9","2.35"
"114418","21","21","18","3","11","2.35"
"117464","19","19","17","2","13","2.35"
"117498","15","15","14","1","12","2.35"
"101365","24","24","22","2","17","2.34"
"103406","17","17","15","2","13","2.34"
"107060","12","12","7","5","5","2.34"
"108232","17","17","16","1","16","2.34"
"109457","5","5","4","1","4","2.34"
"100036","14","14","11","3","6","2.33"
"100086","10","10","10","0","8","2.33"
"100148","16","16","16","0","9","2.33"
"100170","15","15","14","1","11","2.33"
"100176","8","8","8","0","7","2.33"
"100445","11","11","11","0","9","2.33"
"100621","17","17","15","2","8","2.33"
"100630","18","18","13","5","11","2.33"
"100686","12","12","12","0","10","2.33"
"100724","14","14","12","2","8","2.33"
"100807","12","12","12","0","8","2.33"
"101000","13","13","12","1","6","2.33"
"101009","6","6","6","0","3","2.33"
"101157","10","10","10","0","6","2.33"
"101413","14","14","12","2","7","2.33"
"101422","13","13","11","2","9","2.33"
"101520","13","13","11","2","7","2.33"
"101527","7","7","6","1","3","2.33"
"101660","11","11","11","0","7","2.33"
"101740","12","12","10","2","4","2.33"
"101831","13","13","11","2","8","2.33"
"101958","16","16","13","3","10","2.33"
"101967","12","12","10","2","7","2.33"
"102007","22","22","21","1","13","2.33"
"102017","17","17","13","4","10","2.33"
"102089","14","14","14","0","10","2.33"
"102102","12","12","12","0","7","2.33"
"102204","11","11","9","2","3","2.33"
"102309","13","13","12","1","8","2.33"
"102361","15","15","14","1","8","2.33"
"102381","11","11","10","1","5","2.33"
"102433","9","9","8","1","6","2.33"
"102457","11","11","10","1","5","2.33"
"102563","13","13","13","0","8","2.33"
"102585","13","13","12","1","8","2.33"
"102594","18","18","16","2","12","2.33"
"102634","15","15","12","3","6","2.33"
"102637","22","22","19","3","17","2.33"
"102665","7","7","6","1","5","2.33"
"102708","7","7","3","4","3","2.33"
"102843","16","16","13","3","7","2.33"
"103135","15","15","14","1","13","2.33"
"103187","15","15","14","1","12","2.33"
"103453","14","14","13","1","8","2.33"
"103549","14","14","14","0","6","2.33"
"103568","13","13","11","2","10","2.33"
"103648","13","13","12","1","7","2.33"
"103770","13","13","12","1","8","2.33"
"103919","10","10","9","1","7","2.33"
"104015","4","4","3","1","3","2.33"
"104139","19","19","19","0","13","2.33"
"104243","14","14","12","2","8","2.33"
"104255","15","15","12","3","7","2.33"
"104325","14","14","14","0","10","2.33"
"104510","11","11","10","1","6","2.33"
"104536","9","9","9","0","5","2.33"
"104565","6","6","6","0","3","2.33"
"104575","11","11","10","1","5","2.33"
"104633","12","12","11","1","7","2.33"
"104641","12","12","12","0","9","2.33"
"104660","9","9","6","3","3","2.33"
"104708","13","13","13","0","8","2.33"
"104756","15","15","12","3","4","2.33"
"104806","12","12","12","0","7","2.33"
"104954","13","13","12","1","8","2.33"
"105006","15","15","14","1","8","2.33"
"105127","14","14","13","1","11","2.33"
"105173","16","16","16","0","12","2.33"
"105194","12","12","11","1","9","2.33"
"105236","11","11","8","3","4","2.33"
"105335","5","5","5","0","4","2.33"
"105430","12","12","9","3","5","2.33"
"105454","8","8","8","0","6","2.33"
"105559","14","14","13","1","11","2.33"
"105602","13","13","13","0","9","2.33"
"105603","8","8","5","3","3","2.33"
"105649","10","10","8","2","3","2.33"
"105680","16","16","13","3","8","2.33"
"105701","20","20","15","5","9","2.33"
"105842","20","20","20","0","18","2.33"
"105944","11","11","9","2","6","2.33"
"106188","10","10","9","1","7","2.33"
"106210","14","14","13","1","10","2.33"
"106214","17","17","15","2","11","2.33"
"106510","14","14","11","3","9","2.33"
"106563","6","6","6","0","3","2.33"
"106678","8","8","7","1","6","2.33"
"106710","18","18","16","2","9","2.33"
"106763","19","19","17","2","11","2.33"
"106905","22","22","22","0","17","2.33"
"106912","9","9","8","1","8","2.33"
"107012","13","13","13","0","8","2.33"
"107030","10","10","8","2","4","2.33"
"107037","16","16","14","2","9","2.33"
"107043","9","8","9","0","7","2.33"
"107070","12","12","11","1","4","2.33"
"107143","10","10","9","1","8","2.33"
"107166","13","13","13","0","7","2.33"
"107295","11","11","9","2","6","2.33"
"107375","11","11","10","1","5","2.33"
"107380","17","17","16","1","13","2.33"
"107443","12","12","11","1","9","2.33"
"107480","11","11","10","1","10","2.33"
"107533","17","17","16","1","10","2.33"
"107647","9","9","8","1","3","2.33"
"107695","13","13","12","1","9","2.33"
"107789","9","9","8","1","6","2.33"
"107842","8","8","8","0","4","2.33"
"107849","13","13","10","3","7","2.33"
"107962","11","11","9","2","7","2.33"
"107978","10","10","7","3","4","2.33"
"108041","15","15","15","0","9","2.33"
"108190","15","15","12","3","9","2.33"
"108332","6","6","5","1","3","2.33"
"108440","5","5","3","2","3","2.33"
"108555","13","13","12","1","9","2.33"
"108561","17","17","13","4","7","2.33"
"108662","16","16","13","3","9","2.33"
"108885","24","24","23","1","16","2.33"
"108945","17","17","15","2","11","2.33"
"108963","14","14","13","1","7","2.33"
"109001","16","16","14","2","10","2.33"
"109104","12","12","11","1","10","2.33"
"109354","14","14","14","0","6","2.33"
"109409","21","21","18","3","16","2.33"
"109514","11","11","10","1","7","2.33"
"109567","15","15","14","1","10","2.33"
"109733","13","13","12","1","7","2.33"
"109751","12","12","11","1","7","2.33"
"110020","10","10","8","2","6","2.33"
"110172","9","9","7","2","4","2.33"
"110255","15","15","15","0","11","2.33"
"110273","13","13","12","1","9","2.33"
"110352","11","11","10","1","7","2.33"
"110441","12","12","12","0","8","2.33"
"110573","11","11","10","1","8","2.33"
"110706","11","11","11","0","6","2.33"
"110745","7","7","7","0","3","2.33"
"110760","8","8","7","1","4","2.33"
"110896","13","13","11","2","9","2.33"
"111020","12","12","11","1","9","2.33"
"111024","13","13","11","2","11","2.33"
"111034","18","18","15","3","12","2.33"
"111076","9","9","8","1","3","2.33"
"111171","14","14","13","1","9","2.33"
"111467","12","12","8","4","8","2.33"
"111735","7","7","7","0","4","2.33"
"111876","12","12","11","1","8","2.33"
"111932","13","13","12","1","9","2.33"
"112171","8","8","6","2","3","2.33"
"112219","16","16","15","1","10","2.33"
"112277","11","11","11","0","9","2.33"
"112423","16","16","15","1","8","2.33"
"112484","15","15","14","1","9","2.33"
"112685","3","3","3","0","3","2.33"
"112830","15","15","12","3","6","2.33"
"112899","5","5","5","0","3","2.33"
"112900","11","11","8","3","6","2.33"
"112972","10","10","9","1","3","2.33"
"112988","18","18","16","2","10","2.33"
"113077","12","12","10","2","6","2.33"
"113111","14","14","11","3","9","2.33"
"113491","10","10","8","2","3","2.33"
"113572","18","18","16","2","9","2.33"
"113615","15","15","14","1","8","2.33"
"113786","25","25","21","4","18","2.33"
"113896","20","20","16","4","9","2.33"
"113903","13","13","13","0","8","2.33"
"114190","10","10","8","2","4","2.33"
"114224","12","12","11","1","9","2.33"
"114304","8","8","6","2","3","2.33"
"114484","14","14","13","1","6","2.33"
"114637","16","16","15","1","10","2.33"
"114648","8","8","6","2","3","2.33"
"114689","13","13","12","1","7","2.33"
"114752","11","11","10","1","6","2.33"
"114862","16","16","13","3","6","2.33"
"115092","12","12","9","3","8","2.33"
"115126","13","13","11","2","8","2.33"
"115215","14","14","13","1","11","2.33"
"115348","18","18","18","0","12","2.33"
"115435","13","13","11","2","7","2.33"
"115563","9","9","7","2","3","2.33"
"115583","17","17","16","1","8","2.33"
"115596","13","13","11","2","9","2.33"
"115598","22","22","17","5","12","2.33"
"115731","7","7","7","0","5","2.33"
"115831","16","16","14","2","8","2.33"
"115869","14","14","10","4","9","2.33"
"115904","14","14","13","1","10","2.33"
"115919","16","16","15","1","8","2.33"
"115984","14","14","14","0","12","2.33"
"115999","15","15","15","0","10","2.33"
"116018","13","13","11","2","9","2.33"
"116245","10","10","9","1","7","2.33"
"116310","13","13","8","5","6","2.33"
"116329","12","12","10","2","9","2.33"
"116594","15","15","14","1","12","2.33"
"116705","6","6","6","0","4","2.33"
"116858","10","10","10","0","6","2.33"
"116910","8","8","8","0","6","2.33"
"116936","9","9","9","0","6","2.33"
"116970","5","5","5","0","4","2.33"
"117009","18","18","15","3","12","2.33"
"117178","10","10","9","1","7","2.33"
"117210","9","9","9","0","4","2.33"
"117221","12","12","12","0","6","2.33"
"117248","9","9","8","1","6","2.33"
"117336","10","10","8","2","5","2.33"
"101207","16","16","13","3","11","2.32"
"111567","19","19","18","1","12","2.32"
"111720","18","18","17","1","14","2.32"
"117016","24","24","23","1","18","2.32"
"100317","15","15","14","1","10","2.31"
"102497","11","11","11","0","9","2.31"
"102879","14","14","12","2","11","2.31"
"103620","17","17","16","1","11","2.31"
"103668","18","18","16","2","13","2.31"
"103798","12","12","12","0","10","2.31"
"104097","16","16","14","2","11","2.31"
"104230","16","16","14","2","9","2.31"
"104360","14","14","13","1","11","2.31"
"104512","11","11","10","1","10","2.31"
"104956","14","14","13","1","9","2.31"
"106591","18","18","18","0","11","2.31"
"106745","10","10","8","2","7","2.31"
"106830","12","12","11","1","9","2.31"
"106871","15","15","14","1","11","2.31"
"107125","11","11","11","0","8","2.31"
"107625","21","21","20","1","13","2.31"
"107920","14","14","13","1","9","2.31"
"109164","15","15","14","1","11","2.31"
"109943","15","15","14","1","10","2.31"
"110081","17","17","17","0","12","2.31"
"110321","13","13","11","2","10","2.31"
"110415","8","8","8","0","8","2.31"
"110904","17","17","15","2","11","2.31"
"111175","20","20","18","2","9","2.31"
"111957","13","13","12","1","9","2.31"
"112811","12","12","12","0","11","2.31"
"114013","14","14","13","1","10","2.31"
"114442","15","15","14","1","9","2.31"
"115180","13","13","11","2","9","2.31"
"115744","13","13","11","2","10","2.31"
"116021","14","14","13","1","9","2.31"
"116124","19","19","18","1","14","2.31"
"116534","19","19","19","0","12","2.31"
"100614","10","10","10","0","8","2.30"
"100650","13","13","13","0","6","2.30"
"100827","13","13","11","2","8","2.30"
"101059","16","16","11","5","9","2.30"
"101152","11","11","10","1","8","2.30"
"101195","12","12","11","1","7","2.30"
"101552","12","12","10","2","6","2.30"
"101558","12","12","9","3","6","2.30"
"101693","13","13","11","2","6","2.30"
"101793","13","13","11","2","7","2.30"
"101821","14","14","13","1","6","2.30"
"102019","12","12","11","1","6","2.30"
"102137","9","9","7","2","6","2.30"
"102310","15","15","11","4","7","2.30"
"102455","12","12","12","0","7","2.30"
"102825","16","16","15","1","11","2.30"
"103816","20","20","17","3","11","2.30"
"103906","10","10","9","1","7","2.30"
"103908","18","18","18","0","13","2.30"
"104128","13","13","12","1","7","2.30"
"104190","17","17","14","3","9","2.30"
"104355","13","13","11","2","7","2.30"
"104377","13","13","13","0","9","2.30"
"104395","14","14","13","1","10","2.30"
"105051","18","18","13","5","8","2.30"
"105065","13","13","12","1","6","2.30"
"105514","11","11","11","0","7","2.30"
"105592","17","17","17","0","15","2.30"
"105724","13","13","11","2","10","2.30"
"106243","13","13","12","1","6","2.30"
"106553","14","14","12","2","7","2.30"
"107174","10","10","9","1","7","2.30"
"107236","13","13","12","1","6","2.30"
"107439","14","14","11","3","6","2.30"
"107972","21","21","20","1","17","2.30"
"108154","17","17","14","3","10","2.30"
"108210","15","15","13","2","6","2.30"
"108286","10","10","7","3","6","2.30"
"108322","16","16","14","2","10","2.30"
"108402","9","9","8","1","6","2.30"
"108802","10","10","9","1","7","2.30"
"108910","9","9","8","1","6","2.30"
"108921","9","9","9","0","7","2.30"
"109643","17","17","15","2","10","2.30"
"109889","17","17","17","0","13","2.30"
"110175","14","14","13","1","10","2.30"
"110254","13","13","11","2","7","2.30"
"110402","14","14","12","2","10","2.30"
"110756","19","19","19","0","17","2.30"
"110983","16","16","14","2","10","2.30"
"111691","11","11","9","2","6","2.30"
"112082","18","18","17","1","14","2.30"
"112475","18","18","17","1","11","2.30"
"112497","15","15","13","2","7","2.30"
"112786","9","9","8","1","7","2.30"
"112851","16","16","14","2","8","2.30"
"112927","12","12","12","0","6","2.30"
"113131","11","11","9","2","7","2.30"
"113181","17","17","17","0","9","2.30"
"113544","13","13","11","2","6","2.30"
"114457","18","18","15","3","13","2.30"
"114541","14","14","14","0","9","2.30"
"114792","18","18","16","2","13","2.30"
"114986","17","17","15","2","11","2.30"
"116027","11","11","10","1","6","2.30"
"116069","11","11","10","1","7","2.30"
"116277","12","12","9","3","6","2.30"
"116553","8","8","7","1","6","2.30"
"116746","13","13","12","1","10","2.30"
"116904","8","8","7","1","6","2.30"
"100452","16","16","14","2","10","2.29"
"100672","11","11","9","2","7","2.29"
"101133","14","14","10","4","7","2.29"
"101330","14","14","13","1","13","2.29"
"101485","14","14","13","1","10","2.29"
"101680","18","18","17","1","10","2.29"
"101837","17","17","16","1","12","2.29"
"102525","12","12","12","0","7","2.29"
"102713","9","9","8","1","7","2.29"
"102749","9","9","9","0","8","2.29"
"103006","14","14","13","1","10","2.29"
"103214","15","15","14","1","13","2.29"
"103349","13","13","12","1","11","2.29"
"103799","14","14","12","2","8","2.29"
"104800","13","13","13","0","9","2.29"
"104801","12","12","12","0","8","2.29"
"104864","13","13","13","0","10","2.29"
"105067","14","14","14","0","9","2.29"
"105113","17","17","16","1","15","2.29"
"105452","18","18","16","2","13","2.29"
"105703","24","24","20","4","15","2.29"
"105902","13","13","12","1","9","2.29"
"105905","13","13","12","1","11","2.29"
"105918","16","16","16","0","12","2.29"
"106000","17","17","16","1","11","2.29"
"106974","11","11","10","1","7","2.29"
"107147","20","20","18","2","14","2.29"
"107263","13","13","11","2","9","2.29"
"107323","14","14","13","1","8","2.29"
"107333","20","20","20","0","13","2.29"
"107692","13","13","12","1","11","2.29"
"107808","15","14","15","0","11","2.29"
"107908","18","18","17","1","13","2.29"
"108176","17","17","14","3","9","2.29"
"108593","18","18","16","2","9","2.29"
"109281","24","24","19","5","15","2.29"
"109323","20","20","18","2","14","2.29"
"109787","14","14","14","0","12","2.29"
"109950","15","15","12","3","8","2.29"
"109992","14","14","12","2","10","2.29"
"110088","13","13","12","1","7","2.29"
"111601","21","21","20","1","12","2.29"
"111755","17","17","14","3","10","2.29"
"112113","13","13","13","0","10","2.29"
"112149","17","17","16","1","12","2.29"
"112381","13","13","13","0","12","2.29"
"112697","18","18","15","3","11","2.29"
"112699","11","11","10","1","7","2.29"
"112789","12","12","10","2","10","2.29"
"113042","15","15","14","1","11","2.29"
"113566","20","20","17","3","12","2.29"
"113943","16","16","14","2","9","2.29"
"114028","12","12","10","2","7","2.29"
"114773","20","20","14","6","8","2.29"
"115132","14","14","13","1","7","2.29"
"115143","13","13","11","2","10","2.29"
"115616","9","9","9","0","7","2.29"
"116146","10","10","8","2","7","2.29"
"116647","14","14","12","2","7","2.29"
"116801","11","11","11","0","8","2.29"
"117152","14","14","9","5","8","2.29"
"117597","17","17","17","0","11","2.29"
"117603","15","15","14","1","9","2.29"
"100290","15","15","14","1","11","2.28"
"100833","17","17","16","1","13","2.28"
"102382","17","17","13","4","9","2.28"
"102451","17","17","16","1","12","2.28"
"102812","15","15","14","1","11","2.28"
"102975","16","16","13","3","9","2.28"
"103499","12","12","12","0","9","2.28"
"105251","16","16","15","1","10","2.28"
"105643","14","14","13","1","8","2.28"
"106089","10","10","9","1","6","2.28"
"107961","17","17","14","3","10","2.28"
"108022","11","11","10","1","6","2.28"
"108116","21","21","19","2","16","2.28"
"109754","14","14","13","1","11","2.28"
"110059","11","11","11","0","7","2.28"
"111049","14","14","13","1","9","2.28"
"112535","19","19","18","1","15","2.28"
"114211","14","14","14","0","11","2.28"
"115503","15","15","13","2","9","2.28"
"115551","16","16","14","2","10","2.28"
"115712","23","23","22","1","16","2.28"
"116020","16","16","14","2","10","2.28"
"116622","19","19","18","1","12","2.28"
"102043","15","15","15","0","13","2.27"
"102792","11","11","9","2","8","2.27"
"103915","13","13","13","0","8","2.27"
"104614","17","17","16","1","15","2.27"
"104787","11","11","10","1","8","2.27"
"107389","13","13","13","0","9","2.27"
"107599","15","15","14","1","10","2.27"
"108961","10","10","9","1","7","2.27"
"109523","15","15","13","2","7","2.27"
"110435","17","17","14","3","9","2.27"
"110615","17","17","15","2","11","2.27"
"111163","17","17","16","1","15","2.27"
"111978","12","12","11","1","7","2.27"
"112683","12","12","12","0","7","2.27"
"113191","13","13","13","0","9","2.27"
"113545","13","13","12","1","8","2.27"
"113605","15","15","13","2","11","2.27"
"113677","9","9","9","0","7","2.27"
"114016","12","12","12","0","7","2.27"
"114264","12","12","11","1","7","2.27"
"114650","14","14","12","2","9","2.27"
"115830","15","15","15","0","8","2.27"
"115965","12","12","11","1","8","2.27"
"116644","14","14","12","2","9","2.27"
"117470","11","11","9","2","7","2.27"
"100392","15","15","13","2","10","2.26"
"101277","23","23","21","2","17","2.26"
"103726","18","18","15","3","12","2.26"
"105804","18","18","17","1","15","2.26"
"106037","22","22","18","4","12","2.26"
"106231","15","15","15","0","12","2.26"
"108394","11","11","11","0","10","2.26"
"109507","16","16","14","2","11","2.26"
"109586","12","12","12","0","11","2.26"
"110000","24","24","21","3","14","2.26"
"110634","21","21","19","2","12","2.26"
"111214","16","16","16","0","13","2.26"
"111563","19","19","16","3","14","2.26"
"112090","17","17","17","0","12","2.26"
"113738","20","20","17","3","15","2.26"
"114310","25","25","21","4","13","2.26"
"115007","14","14","13","1","10","2.26"
"115797","15","15","14","1","12","2.26"
"100031","13","13","11","2","7","2.25"
"100062","17","17","16","1","13","2.25"
"100073","10","9","10","0","8","2.25"
"100295","26","26","23","3","20","2.25"
"100340","10","10","9","1","7","2.25"
"100350","10","10","9","1","7","2.25"
"100705","15","15","13","2","9","2.25"
"100991","13","13","12","1","10","2.25"
"100992","19","19","15","4","10","2.25"
"101077","9","9","9","0","8","2.25"
"101212","10","10","9","1","7","2.25"
"101226","17","17","16","1","11","2.25"
"101281","15","15","13","2","7","2.25"
"101536","11","11","11","0","4","2.25"
"101646","11","11","9","2","5","2.25"
"101683","11","11","10","1","8","2.25"
"101687","16","16","13","3","10","2.25"
"101827","15","15","14","1","9","2.25"
"101828","15","15","13","2","7","2.25"
"101844","16","16","14","2","9","2.25"
"101887","9","9","7","2","5","2.25"
"101957","8","8","8","0","5","2.25"
"102054","15","15","11","4","6","2.25"
"102279","14","14","14","0","7","2.25"
"102284","8","8","7","1","5","2.25"
"102416","9","9","8","1","5","2.25"
"102469","14","14","14","0","10","2.25"
"102470","10","10","9","1","6","2.25"
"102581","11","11","8","3","5","2.25"
"102732","8","8","7","1","4","2.25"
"102742","14","14","11","3","6","2.25"
"102786","12","12","12","0","6","2.25"
"102816","13","13","12","1","8","2.25"
"102991","7","7","6","1","5","2.25"
"102992","10","10","7","3","5","2.25"
"103024","11","11","9","2","6","2.25"
"103171","10","10","8","2","5","2.25"
"103173","13","13","12","1","10","2.25"
"103176","12","12","10","2","6","2.25"
"103252","15","14","14","1","11","2.25"
"103260","12","12","10","2","6","2.25"
"103353","10","10","9","1","4","2.25"
"103517","8","8","7","1","6","2.25"
"103681","17","17","15","2","8","2.25"
"103727","14","14","11","3","4","2.25"
"103823","18","18","14","4","8","2.25"
"104037","15","15","14","1","8","2.25"
"104059","14","14","11","3","4","2.25"
"104070","15","15","13","2","10","2.25"
"104257","11","11","10","1","5","2.25"
"104336","11","11","11","0","7","2.25"
"104649","17","17","16","1","11","2.25"
"104676","9","9","6","3","3","2.25"
"104694","17","17","17","0","10","2.25"
"104696","12","12","12","0","6","2.25"
"104780","14","14","10","4","8","2.25"
"104839","15","15","14","1","10","2.25"
"104950","11","11","10","1","4","2.25"
"105008","8","8","8","0","5","2.25"
"105217","8","8","8","0","5","2.25"
"105241","12","12","11","1","8","2.25"
"105274","7","7","7","0","5","2.25"
"105387","11","11","10","1","6","2.25"
"105571","6","6","5","1","4","2.25"
"105873","14","14","11","3","6","2.25"
"105899","12","12","10","2","5","2.25"
"106004","14","13","14","0","7","2.25"
"106078","13","13","12","1","8","2.25"
"106117","15","15","12","3","8","2.25"
"106127","19","19","16","3","14","2.25"
"106170","12","12","9","3","7","2.25"
"106228","11","11","8","3","4","2.25"
"106633","10","10","9","1","5","2.25"
"106687","16","16","15","1","8","2.25"
"106730","8","8","8","0","4","2.25"
"106769","14","14","12","2","6","2.25"
"106780","10","10","10","0","6","2.25"
"106858","9","9","8","1","5","2.25"
"107063","11","11","8","3","7","2.25"
"107138","11","11","9","2","5","2.25"
"107298","12","12","12","0","9","2.25"
"107327","9","9","8","1","6","2.25"
"107560","7","7","5","2","4","2.25"
"107750","9","9","9","0","6","2.25"
"108080","7","7","6","1","5","2.25"
"108183","10","10","8","2","4","2.25"
"108409","11","11","10","1","7","2.25"
"108422","11","11","11","0","7","2.25"
"108474","15","15","13","2","6","2.25"
"108631","12","12","11","1","9","2.25"
"108641","10","10","10","0","8","2.25"
"108650","18","18","18","0","13","2.25"
"108694","10","10","9","1","4","2.25"
"108801","17","17","16","1","12","2.25"
"108876","19","19","17","2","12","2.25"
"109059","17","17","16","1","10","2.25"
"109089","7","7","7","0","4","2.25"
"109202","11","11","11","0","10","2.25"
"109241","9","9","7","2","4","2.25"
"109570","16","16","15","1","9","2.25"
"109709","13","13","10","3","7","2.25"
"109775","14","14","11","3","8","2.25"
"109813","14","14","14","0","10","2.25"
"109891","15","15","14","1","9","2.25"
"110155","10","10","9","1","6","2.25"
"110207","12","12","9","3","4","2.25"
"110383","8","8","7","1","6","2.25"
"110540","8","8","8","0","4","2.25"
"110647","9","9","8","1","5","2.25"
"110715","16","16","16","0","8","2.25"
"111060","7","7","7","0","6","2.25"
"111106","18","18","16","2","12","2.25"
"111237","13","13","11","2","5","2.25"
"111399","14","14","14","0","9","2.25"
"111663","7","7","7","0","6","2.25"
"111706","11","11","11","0","8","2.25"
"111716","10","10","9","1","4","2.25"
"111980","9","9","9","0","5","2.25"
"112331","18","18","17","1","9","2.25"
"112340","11","11","10","1","9","2.25"
"112415","13","13","13","0","9","2.25"
"112571","13","13","10","3","8","2.25"
"112691","13","13","13","0","8","2.25"
"112696","19","19","18","1","15","2.25"
"112924","12","12","11","1","5","2.25"
"113103","18","18","16","2","12","2.25"
"113127","19","19","18","1","7","2.25"
"113134","7","7","5","2","4","2.25"
"113161","15","15","13","2","8","2.25"
"113366","12","12","12","0","10","2.25"
"113512","11","11","9","2","6","2.25"
"113539","11","11","10","1","4","2.25"
"113555","10","10","10","0","6","2.25"
"113755","16","16","16","0","10","2.25"
"113820","8","8","7","1","5","2.25"
"114155","11","11","11","0","8","2.25"
"114348","18","18","17","1","14","2.25"
"114537","10","10","9","1","7","2.25"
"114547","8","8","7","1","6","2.25"
"114645","15","15","14","1","10","2.25"
"114786","13","13","11","2","8","2.25"
"114823","8","8","8","0","7","2.25"
"114930","9","9","7","2","5","2.25"
"115065","15","15","13","2","9","2.25"
"115071","15","15","13","2","7","2.25"
"115202","7","7","7","0","4","2.25"
"115527","15","15","13","2","10","2.25"
"115704","18","18","18","0","9","2.25"
"115891","14","14","14","0","8","2.25"
"115988","9","9","7","2","4","2.25"
"116013","16","16","13","3","8","2.25"
"116185","13","13","12","1","10","2.25"
"116282","13","13","10","3","5","2.25"
"116288","14","14","12","2","6","2.25"
"116308","15","15","15","0","10","2.25"
"116340","7","7","6","1","4","2.25"
"116387","9","9","7","2","4","2.25"
"116445","13","13","12","1","8","2.25"
"116497","13","13","12","1","7","2.25"
"116535","11","11","9","2","6","2.25"
"116538","9","9","7","2","5","2.25"
"116725","14","14","13","1","7","2.25"
"116777","13","13","11","2","8","2.25"
"116915","13","13","13","0","10","2.25"
"117043","14","14","13","1","8","2.25"
"117528","9","9","8","1","5","2.25"
"102489","15","15","13","2","10","2.24"
"102682","17","17","15","2","12","2.24"
"107591","18","18","17","1","13","2.24"
"109690","18","18","17","1","13","2.24"
"110566","21","21","15","6","12","2.24"
"110739","13","13","12","1","9","2.24"
"111442","13","13","13","0","11","2.24"
"113145","16","16","15","1","12","2.24"
"101613","13","13","11","2","9","2.23"
"102998","19","19","17","2","11","2.23"
"103650","18","18","17","1","15","2.23"
"104684","17","17","15","2","10","2.23"
"105856","12","12","11","1","8","2.23"
"106434","10","10","9","1","8","2.23"
"113020","17","17","16","1","14","2.23"
"114098","17","17","15","2","12","2.23"
"115224","13","13","12","1","8","2.23"
"100113","12","12","12","0","8","2.22"
"101346","12","12","12","0","9","2.22"
"101377","11","11","9","2","8","2.22"
"101971","18","18","16","2","10","2.22"
"102759","12","12","12","0","8","2.22"
"103049","13","13","12","1","9","2.22"
"103763","12","12","11","1","9","2.22"
"104081","21","21","19","2","14","2.22"
"104567","17","17","17","0","9","2.22"
"104663","18","18","16","2","12","2.22"
"104695","13","13","11","2","9","2.22"
"104706","16","16","15","1","11","2.22"
"105289","12","12","11","1","8","2.22"
"105815","18","18","16","2","11","2.22"
"106102","17","17","16","1","11","2.22"
"106592","11","11","10","1","10","2.22"
"109765","18","18","15","3","9","2.22"
"110064","15","15","15","0","13","2.22"
"110320","8","8","8","0","5","2.22"
"110394","13","13","11","2","7","2.22"
"111042","18","18","17","1","11","2.22"
"111881","19","19","17","2","14","2.22"
"112367","16","16","15","1","11","2.22"
"112954","15","15","15","0","11","2.22"
"113348","18","18","17","1","12","2.22"
"115709","14","14","10","4","8","2.22"
"115768","18","18","18","0","13","2.22"
"116643","13","13","12","1","8","2.22"
"116767","18","18","17","1","13","2.22"
"116886","15","15","15","0","13","2.22"
"100396","11","11","11","0","7","2.21"
"100926","15","15","14","1","8","2.21"
"101156","14","14","12","2","9","2.21"
"101392","18","18","16","2","10","2.21"
"101695","13","13","13","0","9","2.21"
"102188","20","20","20","0","15","2.21"
"102201","16","16","13","3","11","2.21"
"102790","10","10","10","0","8","2.21"
"103276","16","16","11","5","7","2.21"
"103926","13","13","10","3","9","2.21"
"104098","15","15","12","3","8","2.21"
"104303","12","12","11","1","8","2.21"
"104361","16","16","15","1","13","2.21"
"104554","16","16","13","3","10","2.21"
"104914","16","16","14","2","12","2.21"
"105153","15","15","14","1","11","2.21"
"105429","18","18","17","1","10","2.21"
"105847","11","11","11","0","7","2.21"
"105998","15","15","14","1","7","2.21"
"107688","11","11","10","1","7","2.21"
"107852","10","10","9","1","8","2.21"
"108034","15","15","14","1","11","2.21"
"108169","16","16","13","3","8","2.21"
"108544","14","14","13","1","11","2.21"
"108943","19","19","14","5","8","2.21"
"109055","14","14","12","2","10","2.21"
"109656","19","18","15","4","12","2.21"
"109764","18","18","16","2","14","2.21"
"110393","15","15","13","2","8","2.21"
"110652","15","15","12","3","9","2.21"
"111023","21","21","19","2","11","2.21"
"111788","12","12","11","1","8","2.21"
"112521","15","15","14","1","8","2.21"
"112673","19","19","16","3","11","2.21"
"113158","17","17","17","0","12","2.21"
"113464","16","16","13","3","10","2.21"
"113602","16","16","15","1","12","2.21"
"113727","12","12","10","2","8","2.21"
"114039","17","17","14","3","10","2.21"
"115024","13","13","10","3","7","2.21"
"116456","15","15","13","2","10","2.21"
"116860","11","11","11","0","7","2.21"
"117327","14","14","13","1","8","2.21"
"117344","15","15","15","0","9","2.21"
"100246","11","11","8","3","6","2.20"
"100386","12","12","9","3","6","2.20"
"100736","10","10","9","1","5","2.20"
"100907","8","8","7","1","7","2.20"
"101118","14","14","11","3","6","2.20"
"101676","11","11","7","4","5","2.20"
"101906","9","9","9","0","7","2.20"
"101982","17","17","13","4","8","2.20"
"102047","12","12","10","2","7","2.20"
"102139","13","13","12","1","7","2.20"
"102319","16","16","12","4","8","2.20"
"102411","10","10","10","0","6","2.20"
"102532","15","15","11","4","10","2.20"
"102625","13","13","10","3","6","2.20"
"103319","7","7","7","0","6","2.20"
"103776","13","13","12","1","7","2.20"
"103920","18","18","14","4","11","2.20"
"104176","13","13","11","2","6","2.20"
"104617","12","12","10","2","5","2.20"
"105021","12","12","11","1","11","2.20"
"105472","9","9","9","0","7","2.20"
"105483","11","11","10","1","6","2.20"
"105590","9","9","9","0","5","2.20"
"105685","12","12","12","0","9","2.20"
"105709","12","12","11","1","7","2.20"
"105966","18","18","16","2","14","2.20"
"106267","12","12","11","1","6","2.20"
"106303","14","14","13","1","8","2.20"
"106560","16","16","16","0","9","2.20"
"106575","13","13","12","1","9","2.20"
"106791","10","10","9","1","7","2.20"
"107040","15","15","11","4","7","2.20"
"107441","11","11","9","2","6","2.20"
"107484","16","16","13","3","7","2.20"
"107652","12","12","10","2","6","2.20"
"107973","17","17","15","2","6","2.20"
"108039","13","13","13","0","7","2.20"
"108158","9","9","7","2","7","2.20"
"108171","18","18","15","3","12","2.20"
"108364","10","10","8","2","6","2.20"
"108566","20","20","19","1","11","2.20"
"108874","14","14","14","0","12","2.20"
"109034","9","9","8","1","7","2.20"
"109044","8","8","6","2","6","2.20"
"109056","11","11","10","1","6","2.20"
"109106","12","12","10","2","7","2.20"
"109147","12","12","11","1","7","2.20"
"109747","25","25","23","2","12","2.20"
"109796","9","9","8","1","5","2.20"
"109819","12","12","12","0","7","2.20"
"109846","12","12","11","1","6","2.20"
"110041","12","12","12","0","8","2.20"
"110092","15","15","13","2","9","2.20"
"110236","9","9","8","1","5","2.20"
"110263","10","10","10","0","5","2.20"
"110632","10","10","8","2","6","2.20"
"110717","12","12","11","1","8","2.20"
"110850","9","9","9","0","5","2.20"
"110960","15","15","13","2","10","2.20"
"111169","12","12","11","1","9","2.20"
"111276","12","12","12","0","7","2.20"
"111470","14","14","12","2","6","2.20"
"111565","9","9","7","2","6","2.20"
"111748","13","13","13","0","9","2.20"
"111754","14","14","11","3","6","2.20"
"112058","11","11","8","3","5","2.20"
"112307","13","13","13","0","8","2.20"
"112536","18","18","16","2","9","2.20"
"112656","13","13","13","0","7","2.20"
"112963","14","14","12","2","7","2.20"
"113061","8","8","8","0","5","2.20"
"113084","16","16","12","4","9","2.20"
"113329","12","12","10","2","8","2.20"
"113601","15","15","14","1","11","2.20"
"113622","11","11","11","0","8","2.20"
"113646","9","9","8","1","6","2.20"
"113759","11","11","9","2","5","2.20"
"113848","15","14","13","2","11","2.20"
"114051","10","10","10","0","8","2.20"
"114053","13","13","10","3","5","2.20"
"114446","10","10","9","1","6","2.20"
"114525","13","13","12","1","7","2.20"
"114754","14","14","11","3","6","2.20"
"115022","12","12","10","2","7","2.20"
"115051","11","11","11","0","8","2.20"
"115402","12","12","11","1","9","2.20"
"115436","11","11","11","0","7","2.20"
"115746","18","18","16","2","10","2.20"
"115989","12","12","11","1","7","2.20"
"116167","12","12","11","1","8","2.20"
"116274","10","10","9","1","7","2.20"
"116494","11","11","11","0","6","2.20"
"116539","10","10","9","1","5","2.20"
"116702","7","7","7","0","7","2.20"
"117153","12","12","11","1","8","2.20"
"117444","9","9","8","1","5","2.20"
"117562","12","12","10","2","7","2.20"
"100343","16","16","16","0","11","2.19"
"101431","16","16","14","2","12","2.19"
"102153","20","20","17","3","12","2.19"
"103201","14","14","12","2","9","2.19"
"103254","13","13","13","0","10","2.19"
"103538","12","12","12","0","10","2.19"
"105132","10","10","10","0","9","2.19"
"105190","21","21","17","4","11","2.19"
"108410","17","17","17","0","10","2.19"
"109461","13","13","10","3","9","2.19"
"109648","11","11","11","0","7","2.19"
"110057","14","14","13","1","9","2.19"
"110545","18","18","14","4","11","2.19"
"111999","12","12","12","0","9","2.19"
"112042","15","15","13","2","11","2.19"
"112068","14","14","13","1","9","2.19"
"113813","15","15","14","1","10","2.19"
"114817","12","12","10","2","7","2.19"
"115858","14","14","12","2","10","2.19"
"115937","19","19","17","2","12","2.19"
"116509","16","16","16","0","12","2.19"
"116880","13","13","13","0","10","2.19"
"117036","16","16","15","1","10","2.19"
"117107","13","13","12","1","7","2.19"
"103175","16","16","15","1","11","2.18"
"104605","14","14","12","2","10","2.18"
"113096","16","16","16","0","13","2.18"
"113428","16","16","14","2","11","2.18"
"115015","16","16","15","1","12","2.18"
"100286","15","15","12","3","6","2.17"
"100389","15","15","10","5","8","2.17"
"100784","10","10","10","0","8","2.17"
"100872","7","7","7","0","4","2.17"
"101098","13","13","10","3","8","2.17"
"101117","17","17","13","4","8","2.17"
"101170","10","10","9","1","7","2.17"
"101252","7","7","6","1","4","2.17"
"101366","15","15","13","2","7","2.17"
"101488","10","10","10","0","6","2.17"
"101703","11","11","11","0","6","2.17"
"102215","15","15","12","3","8","2.17"
"102491","11","11","10","1","4","2.17"
"102550","11","11","11","0","7","2.17"
"102876","9","9","7","2","4","2.17"
"103169","14","14","13","1","7","2.17"
"103341","11","11","10","1","6","2.17"
"103388","15","15","15","0","10","2.17"
"103663","17","17","14","3","11","2.17"
"103769","16","16","15","1","12","2.17"
"103974","15","15","12","3","8","2.17"
"104182","9","9","9","0","6","2.17"
"104259","13","13","12","1","9","2.17"
"104372","18","17","18","0","14","2.17"
"104416","13","13","8","5","6","2.17"
"104476","16","16","15","1","9","2.17"
"104637","12","12","12","0","9","2.17"
"104681","11","11","9","2","6","2.17"
"104731","11","11","11","0","8","2.17"
"105023","18","18","14","4","7","2.17"
"105424","17","17","15","2","10","2.17"
"105574","12","12","11","1","4","2.17"
"105598","14","14","14","0","8","2.17"
"105618","15","15","14","1","8","2.17"
"105619","17","17","14","3","12","2.17"
"105995","16","16","16","0","10","2.17"
"106062","8","8","8","0","8","2.17"
"106587","9","9","8","1","6","2.17"
"106701","17","17","16","1","13","2.17"
"107014","11","11","11","0","10","2.17"
"107150","9","9","7","2","6","2.17"
"107262","11","11","10","1","8","2.17"
"107549","14","14","13","1","9","2.17"
"107568","13","13","12","1","7","2.17"
"107664","21","21","19","2","14","2.17"
"107674","12","12","12","0","6","2.17"
"107693","12","12","10","2","8","2.17"
"107746","14","14","14","0","11","2.17"
"107752","12","12","10","2","8","2.17"
"107902","14","14","12","2","7","2.17"
"108017","14","14","14","0","9","2.17"
"108476","13","13","9","4","6","2.17"
"108668","11","11","9","2","4","2.17"
"108753","11","11","9","2","6","2.17"
"108759","11","11","9","2","8","2.17"
"108778","17","17","16","1","12","2.17"
"108862","13","13","12","1","9","2.17"
"108991","11","11","9","2","7","2.17"
"109120","16","16","13","3","11","2.17"
"109172","18","18","17","1","11","2.17"
"109537","9","8","8","1","6","2.17"
"109579","7","7","7","0","4","2.17"
"109613","13","13","12","1","10","2.17"
"109769","12","12","12","0","8","2.17"
"109799","8","8","7","1","4","2.17"
"109906","13","13","13","0","6","2.17"
"110047","14","14","13","1","8","2.17"
"110138","15","15","11","4","8","2.17"
"110147","10","10","9","1","7","2.17"
"110229","23","23","23","0","15","2.17"
"110271","9","9","9","0","7","2.17"
"110515","15","15","12","3","6","2.17"
"110553","11","11","9","2","5","2.17"
"111021","15","15","15","0","10","2.17"
"111189","12","12","11","1","9","2.17"
"111203","16","16","15","1","8","2.17"
"111254","13","13","12","1","8","2.17"
"111281","12","12","10","2","6","2.17"
"111313","12","12","11","1","7","2.17"
"111434","7","7","6","1","4","2.17"
"111937","18","18","14","4","11","2.17"
"112129","18","18","13","5","10","2.17"
"112156","13","13","13","0","6","2.17"
"112317","15","15","13","2","9","2.17"
"112464","11","11","10","1","10","2.17"
"113233","17","17","16","1","13","2.17"
"113265","9","9","8","1","6","2.17"
"113389","18","18","14","4","9","2.17"
"113485","18","18","17","1","14","2.17"
"113876","13","12","12","1","11","2.17"
"113967","11","11","11","0","10","2.17"
"113974","11","11","10","1","8","2.17"
"114260","13","13","11","2","7","2.17"
"114338","10","10","10","0","4","2.17"
"114436","16","16","16","0","12","2.17"
"114473","11","11","10","1","8","2.17"
"114482","15","15","14","1","7","2.17"
"114483","15","15","11","4","6","2.17"
"114534","10","10","10","0","6","2.17"
"114538","8","8","8","0","7","2.17"
"114729","19","19","17","2","10","2.17"
"114815","16","16","15","1","10","2.17"
"114821","9","9","8","1","7","2.17"
"114827","12","12","10","2","8","2.17"
"114974","7","7","7","0","5","2.17"
"115001","13","13","12","1","8","2.17"
"115145","15","15","12","3","8","2.17"
"115164","11","11","10","1","4","2.17"
"115237","15","15","14","1","7","2.17"
"115368","15","15","15","0","10","2.17"
"115691","21","21","19","2","10","2.17"
"115792","14","14","14","0","8","2.17"
"116407","12","12","12","0","10","2.17"
"116592","15","15","14","1","11","2.17"
"116751","11","11","10","1","8","2.17"
"116914","8","8","7","1","6","2.17"
"117112","13","13","12","1","8","2.17"
"117140","12","12","12","0","8","2.17"
"117216","9","9","9","0","7","2.17"
"117390","16","16","15","1","13","2.17"
"117595","13","13","11","2","9","2.17"
"109362","14","14","14","0","9","2.16"
"110196","21","21","20","1","14","2.16"
"113795","15","15","14","1","10","2.16"
"100822","13","13","12","1","9","2.15"
"101014","12","12","12","0","9","2.15"
"102492","17","17","15","2","11","2.15"
"102642","24","23","23","1","12","2.15"
"103952","15","15","13","2","10","2.15"
"105246","12","12","12","0","9","2.15"
"107969","18","17","14","4","13","2.15"
"109473","20","20","19","1","14","2.15"
"110606","15","15","14","1","8","2.15"
"113076","11","11","10","1","9","2.15"
"113280","14","14","14","0","11","2.15"
"115922","22","22","18","4","13","2.15"
"117367","14","14","12","2","9","2.15"
"117515","17","17","15","2","11","2.15"
"101004","13","13","11","2","8","2.14"
"101298","21","21","18","3","14","2.14"
"103106","16","16","13","3","10","2.14"
"103346","12","12","10","2","7","2.14"
"103604","14","14","14","0","9","2.14"
"104177","14","14","13","1","9","2.14"
"104333","13","13","13","0","10","2.14"
"104774","14","14","14","0","11","2.14"
"104877","17","17","16","1","13","2.14"
"105565","12","12","12","0","7","2.14"
"105597","16","16","14","2","11","2.14"
"106993","14","14","12","2","8","2.14"
"107492","19","19","14","5","10","2.14"
"107516","13","13","13","0","10","2.14"
"108130","10","10","9","1","8","2.14"
"108492","16","16","13","3","9","2.14"
"108684","10","10","10","0","9","2.14"
"108749","12","12","11","1","10","2.14"
"108913","11","11","10","1","8","2.14"
"108983","14","14","13","1","11","2.14"
"109415","16","16","13","3","7","2.14"
"109483","12","12","11","1","9","2.14"
"110332","10","10","10","0","9","2.14"
"111636","13","13","13","0","11","2.14"
"111830","20","20","18","2","10","2.14"
"111950","16","16","14","2","8","2.14"
"112621","16","16","15","1","10","2.14"
"114007","12","12","10","2","7","2.14"
"114663","20","20","18","2","12","2.14"
"114796","17","17","13","4","9","2.14"
"115043","9","9","9","0","7","2.14"
"115050","14","14","11","3","11","2.14"
"115064","19","19","16","3","12","2.14"
"115473","16","16","14","2","10","2.14"
"115745","16","16","14","2","10","2.14"
"115747","16","16","13","3","10","2.14"
"115950","11","11","11","0","9","2.14"
"116115","10","10","9","1","7","2.14"
"116493","17","17","16","1","12","2.14"
"116555","12","12","12","0","10","2.14"
"116723","12","12","11","1","8","2.14"
"116909","15","15","14","1","11","2.14"
"100078","11","11","11","0","5","2.13"
"101186","10","10","10","0","5","2.13"
"101403","11","10","9","2","5","2.13"
"101701","14","14","13","1","10","2.13"
"102664","15","15","13","2","9","2.13"
"103891","13","13","12","1","10","2.13"
"104380","22","22","20","2","12","2.13"
"105689","12","12","10","2","5","2.13"
"105831","9","9","9","0","6","2.13"
"106028","12","12","12","0","5","2.13"
"106219","14","14","14","0","8","2.13"
"106649","10","10","9","1","6","2.13"
"107628","9","9","8","1","7","2.13"
"107707","11","11","10","1","6","2.13"
"107800","21","21","21","0","14","2.13"
"107885","16","16","15","1","6","2.13"
"108396","14","14","11","3","7","2.13"
"109199","11","11","10","1","9","2.13"
"109364","10","9","7","3","6","2.13"
"109654","17","17","16","1","11","2.13"
"109702","14","14","12","2","10","2.13"
"109705","10","10","10","0","7","2.13"
"109724","16","16","12","4","8","2.13"
"109762","15","15","14","1","9","2.13"
"110582","13","13","12","1","8","2.13"
"110802","10","10","9","1","5","2.13"
"110860","13","13","12","1","7","2.13"
"111425","10","9","9","1","7","2.13"
"111446","15","15","15","0","8","2.13"
"111811","15","15","11","4","8","2.13"
"112049","10","10","9","1","6","2.13"
"112274","12","12","12","0","8","2.13"
"112558","11","11","11","0","9","2.13"
"112579","13","13","12","1","9","2.13"
"112603","14","14","13","1","6","2.13"
"112781","11","11","9","2","5","2.13"
"112814","14","14","12","2","5","2.13"
"113060","14","14","12","2","9","2.13"
"113655","8","8","8","0","5","2.13"
"113674","14","14","13","1","8","2.13"
"113842","13","13","11","2","6","2.13"
"113872","11","11","10","1","6","2.13"
"114020","16","16","14","2","9","2.13"
"114144","11","11","11","0","8","2.13"
"114169","16","16","15","1","9","2.13"
"114241","12","12","11","1","7","2.13"
"114608","11","11","9","2","5","2.13"
"114885","12","12","11","1","10","2.13"
"116190","14","14","14","0","11","2.13"
"116934","9","9","9","0","5","2.13"
"103475","17","17","16","1","10","2.12"
"106857","19","19","17","2","11","2.12"
"107115","18","18","16","2","12","2.12"
"108161","15","15","15","0","13","2.12"
"113814","17","17","16","1","11","2.12"
"115018","18","18","14","4","11","2.12"
"100974","12","12","12","0","7","2.11"
"101258","14","14","14","0","12","2.11"
"101501","20","20","18","2","17","2.11"
"102015","8","8","8","0","5","2.11"
"102136","16","16","14","2","9","2.11"
"102247","17","17","16","1","11","2.11"
"102559","22","22","17","5","12","2.11"
"103566","15","15","12","3","8","2.11"
"104542","10","10","7","3","5","2.11"
"108333","14","14","13","1","9","2.11"
"108399","14","14","13","1","9","2.11"
"108748","14","14","9","5","5","2.11"
"110966","8","8","8","0","5","2.11"
"113843","15","15","14","1","12","2.11"
"113908","16","16","14","2","10","2.11"
"114001","9","9","8","1","5","2.11"
"114629","15","15","12","3","10","2.11"
"115929","17","17","15","2","10","2.11"
"117495","12","12","11","1","9","2.11"
"100107","14","14","12","2","9","2.10"
"100751","20","20","20","0","12","2.10"
"100782","11","11","9","2","6","2.10"
"101326","12","12","11","1","6","2.10"
"101336","16","16","11","5","6","2.10"
"101601","13","13","11","2","6","2.10"
"101742","17","17","17","0","13","2.10"
"102869","12","12","11","1","8","2.10"
"102941","16","16","14","2","8","2.10"
"103035","13","13","13","0","8","2.10"
"103221","7","7","7","0","7","2.10"
"103374","14","14","14","0","12","2.10"
"103657","15","15","14","1","8","2.10"
"103670","16","16","15","1","10","2.10"
"104000","12","12","11","1","7","2.10"
"104151","11","11","8","3","6","2.10"
"104960","14","14","11","3","7","2.10"
"105158","22","22","20","2","13","2.10"
"105557","13","13","12","1","11","2.10"
"106276","14","14","12","2","7","2.10"
"106438","9","9","6","3","6","2.10"
"106706","16","16","16","0","12","2.10"
"107092","11","11","11","0","7","2.10"
"107998","12","12","11","1","7","2.10"
"108008","11","11","10","1","6","2.10"
"108124","9","9","8","1","6","2.10"
"108859","15","15","14","1","8","2.10"
"108900","14","14","12","2","7","2.10"
"109085","15","15","14","1","7","2.10"
"109554","10","10","9","1","6","2.10"
"109632","11","11","11","0","6","2.10"
"110901","13","13","9","4","6","2.10"
"111008","13","13","11","2","7","2.10"
"111664","12","12","10","2","7","2.10"
"111887","15","15","11","4","7","2.10"
"112350","10","10","10","0","8","2.10"
"112387","12","12","11","1","8","2.10"
"112427","9","9","8","1","6","2.10"
"112454","14","14","11","3","9","2.10"
"113183","15","15","12","3","10","2.10"
"113804","7","7","6","1","6","2.10"
"114942","12","12","10","2","6","2.10"
"115557","13","13","11","2","7","2.10"
"116352","18","18","14","4","10","2.10"
"116845","17","17","17","0","12","2.10"
"117477","9","9","8","1","7","2.10"
"103191","16","16","15","1","14","2.09"
"108845","17","17","14","3","13","2.09"
"115174","18","18","18","0","14","2.09"
"100198","12","12","11","1","6","2.08"
"100321","10","10","9","1","6","2.08"
"100589","16","16","12","4","9","2.08"
"101437","7","7","7","0","7","2.08"
"102068","15","15","15","0","12","2.08"
"102308","10","10","10","0","6","2.08"
"102738","17","17","16","1","8","2.08"
"103036","14","14","13","1","9","2.08"
"103122","10","10","10","0","7","2.08"
"103590","13","13","12","1","7","2.08"
"104732","14","14","13","1","11","2.08"
"105047","15","15","11","4","7","2.08"
"105134","14","14","13","1","9","2.08"
"106090","20","20","16","4","10","2.08"
"106163","21","21","21","0","17","2.08"
"106603","10","10","9","1","7","2.08"
"107305","11","11","9","2","6","2.08"
"107680","14","14","13","1","9","2.08"
"107721","12","12","10","2","8","2.08"
"107758","17","17","15","2","10","2.08"
"108191","15","15","13","2","8","2.08"
"108571","17","17","16","1","7","2.08"
"109313","12","12","12","0","9","2.08"
"110666","15","15","15","0","7","2.08"
"110897","13","13","10","3","8","2.08"
"111122","8","8","8","0","7","2.08"
"111421","9","9","9","0","7","2.08"
"111799","12","12","12","0","8","2.08"
"112139","16","16","14","2","7","2.08"
"112503","12","12","10","2","7","2.08"
"113192","16","16","14","2","6","2.08"
"113543","12","12","10","2","6","2.08"
"113585","12","12","11","1","9","2.08"
"113616","18","18","16","2","9","2.08"
"113723","12","12","11","1","7","2.08"
"114466","12","12","10","2","8","2.08"
"114524","11","11","9","2","7","2.08"
"114578","9","9","9","0","7","2.08"
"114755","16","16","15","1","10","2.08"
"115591","11","11","9","2","9","2.08"
"115847","20","20","20","0","13","2.08"
"116161","9","9","9","0","8","2.08"
"116390","13","13","12","1","7","2.08"
"116683","11","11","11","0","8","2.08"
"116790","14","14","12","2","7","2.08"
"117027","11","11","10","1","9","2.08"
"117123","10","10","9","1","7","2.08"
"117232","13","13","13","0","11","2.08"
"117376","13","13","12","1","8","2.08"
"100438","10","10","10","0","8","2.07"
"101970","14","14","13","1","9","2.07"
"101980","12","12","12","0","7","2.07"
"103110","17","17","14","3","11","2.07"
"103400","9","9","9","0","9","2.07"
"103701","21","21","16","5","10","2.07"
"103829","18","18","16","2","14","2.07"
"104214","14","14","13","1","9","2.07"
"105822","9","9","8","1","7","2.07"
"105979","17","17","15","2","9","2.07"
"106021","19","19","18","1","9","2.07"
"106195","17","17","15","2","9","2.07"
"107742","14","14","14","0","7","2.07"
"107848","15","15","11","4","8","2.07"
"107995","19","19","15","4","10","2.07"
"108021","16","16","15","1","8","2.07"
"109073","9","9","9","0","8","2.07"
"109163","14","14","14","0","10","2.07"
"109692","10","10","9","1","7","2.07"
"109809","19","19","16","3","13","2.07"
"110300","18","18","15","3","12","2.07"
"110329","15","15","15","0","7","2.07"
"110519","13","13","12","1","8","2.07"
"110585","14","14","12","2","8","2.07"
"111022","16","16","15","1","10","2.07"
"111464","12","12","12","0","9","2.07"
"112229","11","11","9","2","8","2.07"
"112807","17","17","14","3","10","2.07"
"113477","19","19","16","3","13","2.07"
"114273","20","20","19","1","12","2.07"
"115498","17","17","16","1","13","2.07"
"116170","16","16","15","1","11","2.07"
"117006","15","15","12","3","7","2.07"
"100088","22","22","21","1","16","2.06"
"101416","12","12","10","2","9","2.06"
"102537","16","16","15","1","11","2.06"
"102817","13","13","12","1","8","2.06"
"104841","11","11","11","0","8","2.06"
"105191","16","16","15","1","10","2.06"
"105401","10","10","9","1","9","2.06"
"105645","14","14","14","0","12","2.06"
"106321","14","14","11","3","8","2.06"
"106982","19","19","15","4","9","2.06"
"107514","18","18","17","1","12","2.06"
"109510","15","15","15","0","10","2.06"
"110466","13","13","12","1","9","2.06"
"110727","21","21","21","0","10","2.06"
"111035","17","17","15","2","10","2.06"
"111346","15","15","11","4","8","2.06"
"112326","13","13","13","0","9","2.06"
"114808","14","14","12","2","10","2.06"
"115070","15","15","15","0","8","2.06"
"115410","17","17","17","0","13","2.06"
"116111","17","17","17","0","10","2.06"
"117234","16","16","15","1","10","2.06"
"102773","14","14","14","0","9","2.05"
"103082","14","14","14","0","11","2.05"
"103565","15","15","15","0","12","2.05"
"106165","13","13","11","2","9","2.05"
"107985","12","12","12","0","9","2.05"
"108000","11","11","10","1","8","2.05"
"108419","21","21","18","3","12","2.05"
"111749","14","14","13","1","11","2.05"
"113165","15","15","14","1","9","2.05"
"115429","16","16","15","1","15","2.05"
"116685","19","19","19","0","14","2.05"
"102796","11","11","11","0","7","2.04"
"104419","16","16","13","3","8","2.04"
"104845","12","12","12","0","11","2.04"
"106384","18","18","14","4","10","2.04"
"107316","14","14","14","0","9","2.04"
"109857","12","12","12","0","10","2.04"
"111628","13","13","13","0","10","2.04"
"112338","16","16","15","1","10","2.04"
"115317","17","17","14","3","9","2.04"
"101758","13","13","12","1","8","2.03"
"112117","13","13","12","1","9","2.03"
"113352","13","13","9","4","9","2.03"
"114325","16","16","14","2","10","2.03"
"115255","14","14","14","0","10","2.03"
"115439","17","17","14","3","12","2.03"
"116109","16","16","15","1","11","2.03"
"116938","23","23","22","1","14","2.03"
"105865","17","17","14","3","11","2.02"
"109182","16","16","16","0","13","2.02"
"113208","12","12","12","0","9","2.02"
"115155","12","12","11","1","11","2.02"
"115874","20","20","18","2","15","2.02"
"100027","13","13","11","2","8","2.00"
"100122","12","12","9","3","4","2.00"
"100287","17","17","16","1","9","2.00"
"100375","12","12","11","1","5","2.00"
"100426","11","11","9","2","6","2.00"
"100493","5","5","5","0","4","2.00"
"100581","7","7","5","2","3","2.00"
"100627","13","13","10","3","9","2.00"
"100791","14","14","11","3","8","2.00"
"100838","9","9","8","1","4","2.00"
"100839","12","12","11","1","6","2.00"
"100846","13","13","11","2","6","2.00"
"100881","15","15","11","4","7","2.00"
"101013","10","10","9","1","7","2.00"
"101055","9","9","8","1","5","2.00"
"101095","14","14","14","0","8","2.00"
"101214","7","7","7","0","4","2.00"
"101225","12","12","9","3","3","2.00"
"101293","13","13","12","1","7","2.00"
"101343","14","14","13","1","8","2.00"
"101401","14","14","13","1","8","2.00"
"101556","8","8","7","1","7","2.00"
"101559","14","14","14","0","9","2.00"
"101566","15","15","14","1","7","2.00"
"101594","12","12","10","2","6","2.00"
"101629","9","9","9","0","4","2.00"
"101709","14","14","10","4","4","2.00"
"101769","10","10","9","1","6","2.00"
"101783","9","9","8","1","5","2.00"
"101875","11","11","9","2","5","2.00"
"101904","9","9","7","2","5","2.00"
"101911","11","11","10","1","5","2.00"
"101931","16","16","14","2","10","2.00"
"102039","11","11","11","0","8","2.00"
"102258","17","17","13","4","8","2.00"
"102316","14","14","12","2","6","2.00"
"102374","7","7","7","0","4","2.00"
"102412","7","7","7","0","7","2.00"
"102425","6","6","5","1","2","2.00"
"102444","14","14","13","1","6","2.00"
"102615","15","15","15","0","12","2.00"
"102875","16","16","16","0","9","2.00"
"102890","11","11","10","1","7","2.00"
"102900","15","15","13","2","6","2.00"
"102931","18","18","16","2","8","2.00"
"103069","14","14","13","1","8","2.00"
"103152","18","18","16","2","6","2.00"
"103246","14","14","13","1","5","2.00"
"103298","15","15","13","2","8","2.00"
"103444","13","13","13","0","9","2.00"
"103450","12","12","12","0","6","2.00"
"103508","10","10","9","1","5","2.00"
"103515","12","12","10","2","3","2.00"
"103753","9","9","9","0","3","2.00"
"103832","14","14","13","1","6","2.00"
"103856","14","14","13","1","4","2.00"
"103867","10","10","8","2","6","2.00"
"103994","15","15","13","2","9","2.00"
"104135","15","15","15","0","7","2.00"
"104201","13","13","12","1","9","2.00"
"104284","13","13","11","2","8","2.00"
"104341","14","14","12","2","9","2.00"
"104353","8","8","4","4","3","2.00"
"104402","14","14","10","4","4","2.00"
"104456","12","12","9","3","5","2.00"
"104479","15","15","12","3","6","2.00"
"104588","15","15","12","3","5","2.00"
"104621","13","13","12","1","6","2.00"
"104635","11","11","9","2","3","2.00"
"104728","20","20","19","1","12","2.00"
"104735","11","11","8","3","4","2.00"
"104977","12","12","9","3","5","2.00"
"105032","9","9","8","1","6","2.00"
"105145","4","4","4","0","3","2.00"
"105229","13","13","13","0","4","2.00"
"105243","17","17","14","3","7","2.00"
"105458","12","12","9","3","8","2.00"
"105660","8","8","8","0","3","2.00"
"105849","7","7","6","1","3","2.00"
"105910","15","15","13","2","10","2.00"
"106359","13","13","10","3","7","2.00"
"106463","10","10","10","0","6","2.00"
"106551","12","12","11","1","9","2.00"
"106653","16","16","14","2","10","2.00"
"106675","10","10","8","2","3","2.00"
"106721","15","15","14","1","10","2.00"
"107039","8","8","7","1","6","2.00"
"107107","11","11","9","2","6","2.00"
"107157","7","7","6","1","2","2.00"
"107197","9","9","8","1","7","2.00"
"107199","9","9","9","0","5","2.00"
"107457","10","10","9","1","9","2.00"
"107489","16","16","14","2","8","2.00"
"107521","15","15","12","3","9","2.00"
"107537","13","13","12","1","8","2.00"
"107555","9","9","9","0","8","2.00"
"107586","9","9","8","1","5","2.00"
"107619","8","8","7","1","4","2.00"
"107671","15","15","14","1","10","2.00"
"107724","7","7","4","3","2","2.00"
"107777","9","9","8","1","6","2.00"
"107875","16","16","15","1","10","2.00"
"107904","10","10","10","0","8","2.00"
"107906","12","12","11","1","8","2.00"
"108172","14","14","13","1","7","2.00"
"108222","12","12","12","0","8","2.00"
"108269","19","19","18","1","14","2.00"
"108428","13","13","11","2","9","2.00"
"108456","13","13","13","0","7","2.00"
"108467","12","12","11","1","8","2.00"
"108546","7","7","4","3","3","2.00"
"108556","8","8","8","0","5","2.00"
"108680","7","7","7","0","3","2.00"
"108707","11","11","10","1","7","2.00"
"108950","12","12","10","2","5","2.00"
"109101","11","11","8","3","5","2.00"
"109121","17","17","16","1","11","2.00"
"109168","11","11","8","3","5","2.00"
"109283","13","13","12","1","6","2.00"
"109312","7","7","6","1","4","2.00"
"109377","21","21","17","4","12","2.00"
"109516","11","11","8","3","6","2.00"
"109738","17","17","14","3","9","2.00"
"109761","12","12","9","3","3","2.00"
"109937","11","11","10","1","6","2.00"
"109973","18","18","17","1","15","2.00"
"110016","17","17","14","3","10","2.00"
"110048","16","16","16","0","9","2.00"
"110284","9","9","7","2","6","2.00"
"110297","12","12","11","1","6","2.00"
"110299","15","15","11","4","10","2.00"
"110591","16","16","14","2","8","2.00"
"110683","8","8","7","1","4","2.00"
"110842","8","8","8","0","3","2.00"
"110869","10","10","8","2","6","2.00"
"111028","12","12","11","1","7","2.00"
"111105","10","10","8","2","3","2.00"
"111112","12","12","11","1","8","2.00"
"111116","11","11","9","2","5","2.00"
"111147","18","18","16","2","10","2.00"
"111155","10","10","8","2","7","2.00"
"111229","9","9","8","1","6","2.00"
"111294","14","14","12","2","9","2.00"
"111371","5","5","5","0","3","2.00"
"111498","13","13","13","0","9","2.00"
"111523","5","5","5","0","3","2.00"
"111578","17","17","12","5","5","2.00"
"111608","12","12","11","1","4","2.00"
"111686","14","14","13","1","11","2.00"
"111891","12","12","11","1","11","2.00"
"111897","6","6","5","1","3","2.00"
"111918","9","9","7","2","3","2.00"
"111958","15","15","13","2","6","2.00"
"111996","12","12","12","0","11","2.00"
"112130","16","16","15","1","7","2.00"
"112202","13","13","13","0","7","2.00"
"112359","10","10","9","1","4","2.00"
"112430","16","16","12","4","9","2.00"
"112435","11","11","10","1","7","2.00"
"112530","10","10","7","3","4","2.00"
"112618","11","11","8","3","7","2.00"
"112714","14","14","13","1","8","2.00"
"112741","12","12","12","0","9","2.00"
"112749","7","7","7","0","3","2.00"
"112809","11","11","8","3","5","2.00"
"112818","13","13","12","1","5","2.00"
"112895","13","13","13","0","9","2.00"
"112909","11","11","9","2","6","2.00"
"112962","14","14","13","1","12","2.00"
"112967","8","8","7","1","4","2.00"
"112968","12","12","10","2","5","2.00"
"113005","15","15","13","2","7","2.00"
"113295","12","12","12","0","8","2.00"
"113395","13","13","12","1","8","2.00"
"113441","14","14","12","2","7","2.00"
"113637","8","8","6","2","4","2.00"
"113642","5","5","5","0","5","2.00"
"113649","13","13","12","1","9","2.00"
"113653","15","15","14","1","7","2.00"
"113739","13","13","11","2","8","2.00"
"113752","13","13","12","1","8","2.00"
"113811","12","12","10","2","7","2.00"
"113817","15","15","14","1","9","2.00"
"113852","9","9","6","3","5","2.00"
"113946","6","6","6","0","5","2.00"
"113956","11","11","9","2","5","2.00"
"114011","14","14","14","0","12","2.00"
"114031","6","6","5","1","3","2.00"
"114114","10","10","9","1","7","2.00"
"114149","9","9","8","1","5","2.00"
"114586","9","9","9","0","5","2.00"
"114622","8","8","7","1","4","2.00"
"114780","9","9","8","1","3","2.00"
"114881","9","9","9","0","5","2.00"
"115012","10","10","10","0","7","2.00"
"115040","11","11","10","1","7","2.00"
"115056","9","9","8","1","4","2.00"
"115417","8","8","8","0","7","2.00"
"115497","12","12","10","2","5","2.00"
"115784","11","11","10","1","7","2.00"
"116078","5","5","4","1","1","2.00"
"116088","14","14","12","2","7","2.00"
"116176","6","6","4","2","4","2.00"
"116222","12","12","11","1","8","2.00"
"116265","14","14","12","2","8","2.00"
"116335","13","13","10","3","7","2.00"
"116394","18","18","18","0","13","2.00"
"116408","11","11","9","2","4","2.00"
"116526","11","11","10","1","4","2.00"
"116593","13","13","11","2","9","2.00"
"116626","9","9","9","0","4","2.00"
"116628","18","18","16","2","10","2.00"
"116771","19","19","16","3","12","2.00"
"116796","9","9","9","0","6","2.00"
"116840","9","9","8","1","3","2.00"
"116895","15","15","14","1","8","2.00"
"116901","14","14","13","1","8","2.00"
"116908","13","13","12","1","8","2.00"
"116990","17","17","17","0","11","2.00"
"117001","9","8","7","2","3","2.00"
"117218","10","10","7","3","1","2.00"
"117302","10","10","10","0","7","2.00"
"117331","16","16","15","1","9","2.00"
"117540","10","10","8","2","5","2.00"
"117552","11","11","10","1","4","2.00"
"104820","16","16","14","2","11","1.98"
"106958","13","13","12","1","9","1.98"
"107502","20","20","20","0","13","1.98"
"110379","18","18","17","1","14","1.98"
"111781","23","23","22","1","15","1.98"
"113344","14","14","13","1","10","1.98"
"115057","14","14","12","2","11","1.98"
"117233","16","16","16","0","14","1.98"
"100557","11","11","10","1","9","1.97"
"101946","18","18","16","2","12","1.97"
"103420","17","17","16","1","10","1.97"
"104915","14","14","10","4","9","1.97"
"107422","14","14","12","2","9","1.97"
"110721","17","17","16","1","10","1.97"
"111503","22","21","22","0","15","1.97"
"114154","16","16","15","1","11","1.97"
"100352","17","17","17","0","13","1.96"
"105466","16","16","14","2","9","1.96"
"105665","11","11","11","0","7","1.96"
"109595","18","18","16","2","13","1.96"
"103916","18","18","18","0","10","1.95"
"104647","21","21","17","4","13","1.95"
"106876","21","21","19","2","11","1.95"
"110114","21","21","18","3","13","1.95"
"110564","14","14","14","0","10","1.95"
"112692","14","14","12","2","9","1.95"
"114548","13","13","13","0","8","1.95"
"114713","18","18","17","1","13","1.95"
"101350","11","11","10","1","7","1.94"
"101643","13","13","11","2","8","1.94"
"101832","16","16","14","2","9","1.94"
"104805","16","16","14","2","9","1.94"
"107427","16","16","15","1","13","1.94"
"107498","11","11","9","2","8","1.94"
"108408","11","11","11","0","10","1.94"
"109339","20","20","13","7","6","1.94"
"110269","14","14","12","2","7","1.94"
"112131","11","11","11","0","6","1.94"
"112545","13","13","13","0","10","1.94"
"112594","17","17","16","1","14","1.94"
"116177","14","14","12","2","9","1.94"
"116815","21","21","16","5","10","1.94"
"117395","17","17","17","0","11","1.94"
"117500","20","20","19","1","8","1.94"
"100238","14","14","13","1","8","1.93"
"100700","14","14","13","1","9","1.93"
"100829","11","11","11","0","7","1.93"
"101644","15","15","13","2","10","1.93"
"102200","12","12","11","1","9","1.93"
"102671","22","22","21","1","11","1.93"
"102683","11","11","10","1","9","1.93"
"103207","13","13","10","3","7","1.93"
"106665","14","14","12","2","9","1.93"
"108058","14","14","14","0","9","1.93"
"108857","10","10","9","1","8","1.93"
"109233","17","17","14","3","8","1.93"
"109245","17","17","15","2","11","1.93"
"109550","18","18","18","0","12","1.93"
"110668","17","17","17","0","10","1.93"
"112029","11","11","8","3","8","1.93"
"112849","13","13","13","0","10","1.93"
"113559","13","13","11","2","7","1.93"
"113746","14","14","12","2","11","1.93"
"113965","13","13","11","2","9","1.93"
"115468","13","13","12","1","9","1.93"
"116768","13","13","13","0","10","1.93"
"116898","10","10","10","0","9","1.93"
"117011","20","20","15","5","9","1.93"
"100283","13","13","11","2","6","1.92"
"101125","12","12","11","1","8","1.92"
"101625","16","16","16","0","11","1.92"
"101857","13","13","12","1","7","1.92"
"102739","16","16","16","0","9","1.92"
"102806","13","13","11","2","8","1.92"
"103043","17","17","14","3","11","1.92"
"103192","18","18","14","4","9","1.92"
"103445","14","14","12","2","9","1.92"
"103739","17","17","14","3","9","1.92"
"104096","16","16","14","2","7","1.92"
"104475","15","15","13","2","11","1.92"
"104492","14","14","13","1","8","1.92"
"104603","12","12","11","1","10","1.92"
"104763","10","10","8","2","6","1.92"
"104843","15","15","14","1","8","1.92"
"105000","21","21","19","2","13","1.92"
"106938","15","15","14","1","7","1.92"
"107930","13","13","12","1","7","1.92"
"109095","15","15","14","1","8","1.92"
"109129","14","14","12","2","7","1.92"
"109423","12","12","11","1","8","1.92"
"109515","14","14","9","5","7","1.92"
"109522","15","15","15","0","12","1.92"
"109875","15","15","11","4","8","1.92"
"112383","15","15","14","1","7","1.92"
"112438","16","16","15","1","10","1.92"
"112662","13","13","12","1","9","1.92"
"112708","15","15","14","1","9","1.92"
"113035","12","12","11","1","7","1.92"
"115295","13","13","13","0","11","1.92"
"115618","17","17","14","3","9","1.92"
"115711","14","14","14","0","8","1.92"
"116358","10","10","7","3","5","1.92"
"116902","13","13","12","1","8","1.92"
"114238","14","14","12","2","11","1.91"
"100110","10","10","9","1","7","1.90"
"100265","16","16","15","1","10","1.90"
"101870","10","10","8","2","6","1.90"
"101959","13","13","13","0","8","1.90"
"101992","13","13","11","2","7","1.90"
"102138","14","14","13","1","6","1.90"
"102328","12","12","10","2","6","1.90"
"103133","11","11","9","2","7","1.90"
"103611","12","12","10","2","8","1.90"
"103652","11","11","9","2","6","1.90"
"103814","8","8","8","0","8","1.90"
"104020","11","11","9","2","6","1.90"
"104540","11","11","9","2","6","1.90"
"104576","12","12","11","1","6","1.90"
"105074","24","24","18","6","13","1.90"
"105238","12","12","11","1","7","1.90"
"105692","17","17","14","3","10","1.90"
"105754","10","10","8","2","6","1.90"
"105951","7","7","6","1","6","1.90"
"107145","14","14","12","2","7","1.90"
"108988","11","11","10","1","6","1.90"
"109327","12","12","9","3","7","1.90"
"109505","16","16","14","2","6","1.90"
"111681","12","12","11","1","7","1.90"
"112554","11","11","9","2","8","1.90"
"112866","9","9","8","1","6","1.90"
"113911","10","10","9","1","7","1.90"
"114789","14","14","11","3","6","1.90"
"114831","11","11","11","0","6","1.90"
"115055","18","18","16","2","8","1.90"
"116263","15","15","12","3","6","1.90"
"116312","11","11","8","3","6","1.90"
"116328","10","10","10","0","6","1.90"
"116859","13","13","10","3","6","1.90"
"117165","12","12","12","0","9","1.90"
"117615","17","17","16","1","11","1.90"
"102110","14","14","12","2","7","1.89"
"107465","19","19","19","0","13","1.89"
"108930","15","15","14","1","10","1.89"
"109791","13","13","13","0","9","1.89"
"110654","9","9","8","1","8","1.89"
"113621","15","15","14","1","10","1.89"
"100075","11","11","11","0","7","1.88"
"101656","14","14","12","2","5","1.88"
"104007","13","13","12","1","7","1.88"
"104218","12","12","11","1","5","1.88"
"104549","5","5","5","0","5","1.88"
"104761","10","10","9","1","5","1.88"
"105005","25","25","22","3","14","1.88"
"105261","18","18","16","2","11","1.88"
"105881","11","11","11","0","5","1.88"
"105943","11","11","10","1","7","1.88"
"105959","14","14","11","3","5","1.88"
"106726","10","10","9","1","7","1.88"
"106843","16","16","16","0","11","1.88"
"107997","14","14","14","0","10","1.88"
"108156","17","17","15","2","6","1.88"
"108620","14","14","13","1","10","1.88"
"109078","10","10","9","1","6","1.88"
"109142","16","15","15","1","10","1.88"
"109161","15","15","13","2","6","1.88"
"109499","11","11","11","0","8","1.88"
"110975","13","13","13","0","8","1.88"
"112795","11","11","8","3","5","1.88"
"114280","16","16","14","2","6","1.88"
"115649","8","8","8","0","5","1.88"
"115652","14","14","13","1","10","1.88"
"116789","12","12","10","2","5","1.88"
"116967","14","14","13","1","9","1.88"
"117617","9","9","9","0","5","1.88"
"100300","11","11","10","1","9","1.87"
"100695","11","11","10","1","9","1.87"
"104468","14","14","11","3","7","1.87"
"106669","12","12","12","0","8","1.87"
"108244","13","13","13","0","9","1.87"
"117508","11","11","10","1","7","1.87"
"102938","17","17","15","2","11","1.86"
"107008","17","17","14","3","10","1.86"
"110058","13","13","11","2","9","1.86"
"111108","13","13","11","2","8","1.86"
"111150","14","14","12","2","7","1.86"
"111962","19","19","17","2","9","1.86"
"112615","18","18","16","2","9","1.86"
"114366","16","16","15","1","10","1.86"
"116744","11","11","9","2","7","1.86"
"101300","16","16","14","2","8","1.85"
"108936","14","14","14","0","11","1.85"
"110392","20","20","20","0","12","1.85"
"113838","13","13","12","1","8","1.85"
"115316","18","18","15","3","13","1.85"
"109471","9","9","5","4","4","1.84"
"114075","7","7","5","2","4","1.84"
"100021","11","11","10","1","7","1.83"
"101069","12","12","11","1","7","1.83"
"101471","12","12","11","1","6","1.83"
"102021","14","14","11","3","8","1.83"
"102079","16","16","13","3","7","1.83"
"103428","13","13","10","3","9","1.83"
"103577","11","11","9","2","6","1.83"
"103629","14","14","14","0","8","1.83"
"104018","11","11","8","3","4","1.83"
"104205","12","12","11","1","8","1.83"
"104835","13","13","11","2","5","1.83"
"104935","12","12","11","1","5","1.83"
"105066","12","12","12","0","8","1.83"
"105868","11","11","10","1","4","1.83"
"105937","9","9","9","0","4","1.83"
"106023","13","13","10","3","7","1.83"
"106233","18","18","15","3","8","1.83"
"106570","16","16","14","2","11","1.83"
"106578","14","14","13","1","7","1.83"
"106611","9","9","9","0","5","1.83"
"106718","15","15","11","4","6","1.83"
"106936","14","14","14","0","8","1.83"
"107067","8","8","7","1","6","1.83"
"108925","11","11","9","2","6","1.83"
"109082","16","16","16","0","8","1.83"
"109091","9","9","6","3","4","1.83"
"109658","10","10","9","1","6","1.83"
"109773","14","14","12","2","8","1.83"
"110033","13","13","11","2","7","1.83"
"110436","13","13","10","3","7","1.83"
"110597","15","15","13","2","9","1.83"
"111458","11","11","11","0","6","1.83"
"111507","9","9","8","1","6","1.83"
"111814","11","11","9","2","5","1.83"
"112119","10","10","8","2","7","1.83"
"112643","12","12","12","0","7","1.83"
"113497","14","14","14","0","7","1.83"
"114112","9","9","8","1","7","1.83"
"114174","8","8","6","2","4","1.83"
"114232","15","15","13","2","8","1.83"
"114407","16","16","13","3","7","1.83"
"115025","15","15","13","2","8","1.83"
"115242","16","16","16","0","10","1.83"
"115338","16","16","14","2","10","1.83"
"115406","10","10","10","0","5","1.83"
"115486","15","15","13","2","8","1.83"
"115592","11","11","10","1","7","1.83"
"115613","12","12","11","1","8","1.83"
"115724","12","11","11","1","6","1.83"
"116128","12","12","9","3","4","1.83"
"116660","12","12","11","1","7","1.83"
"116690","16","16","13","3","7","1.83"
"117353","18","18","17","1","14","1.83"
"117356","12","12","11","1","8","1.83"
"117407","12","12","11","1","4","1.83"
"117586","15","15","10","5","4","1.83"
"117612","23","23","21","2","13","1.82"
"110330","12","12","12","0","10","1.81"
"110347","14","14","13","1","11","1.81"
"114181","17","17","15","2","10","1.81"
"114209","18","18","14","4","9","1.81"
"115042","14","14","11","3","9","1.81"
"117440","21","21","17","4","10","1.81"
"100054","10","10","9","1","6","1.80"
"100608","14","14","14","0","7","1.80"
"100656","21","21","17","4","9","1.80"
"100702","8","8","7","1","5","1.80"
"102218","19","19","16","3","13","1.80"
"102233","8","8","8","0","5","1.80"
"102320","10","10","9","1","5","1.80"
"103950","17","17","10","7","6","1.80"
"104084","14","14","9","5","7","1.80"
"105057","17","16","16","1","13","1.80"
"106401","11","11","9","2","7","1.80"
"106919","11","11","10","1","7","1.80"
"107893","13","13","12","1","5","1.80"
"108025","10","10","9","1","7","1.80"
"108623","10","10","8","2","6","1.80"
"109066","11","11","11","0","5","1.80"
"109406","10","10","7","3","6","1.80"
"110848","11","11","11","0","7","1.80"
"111096","10","10","9","1","7","1.80"
"111870","15","15","15","0","9","1.80"
"111879","8","8","8","0","5","1.80"
"112007","10","10","10","0","6","1.80"
"112856","16","16","11","5","8","1.80"
"113302","10","10","9","1","6","1.80"
"114416","15","15","14","1","10","1.80"
"115993","19","19","14","5","8","1.80"
"116087","13","13","11","2","5","1.80"
"116478","9","9","6","3","5","1.80"
"116567","13","13","12","1","6","1.80"
"116570","10","10","9","1","5","1.80"
"116755","15","15","13","2","8","1.80"
"117017","13","13","12","1","5","1.80"
"117448","11","11","8","3","5","1.80"
"100026","13","13","12","1","8","1.79"
"101257","12","12","11","1","10","1.79"
"102592","12","12","11","1","8","1.79"
"105605","19","19","19","0","14","1.79"
"106607","15","15","15","0","12","1.79"
"107204","18","18","15","3","10","1.79"
"107769","11","11","11","0","8","1.79"
"108765","12","12","11","1","9","1.79"
"113029","17","17","15","2","12","1.79"
"114471","16","16","16","0","10","1.79"
"115218","15","15","13","2","8","1.79"
"115329","15","15","14","1","10","1.79"
"115614","12","12","10","2","8","1.79"
"117122","16","16","15","1","9","1.79"
"117293","15","15","14","1","8","1.79"
"117430","13","13","13","0","9","1.79"
"117505","16","16","14","2","8","1.79"
"101342","13","13","10","3","8","1.78"
"101776","23","23","20","3","13","1.78"
"103818","14","14","13","1","5","1.78"
"106246","13","13","12","1","7","1.78"
"107007","13","13","12","1","9","1.78"
"107258","9","9","8","1","5","1.78"
"109707","14","14","12","2","6","1.78"
"111554","11","11","10","1","5","1.78"
"113207","11","11","10","1","5","1.78"
"117338","22","22","21","1","15","1.78"
"112616","14","14","13","1","8","1.77"
"101296","21","21","19","2","12","1.76"
"100087","10","10","9","1","4","1.75"
"100332","9","9","9","0","6","1.75"
"101017","6","6","6","0","4","1.75"
"101295","9","9","7","2","3","1.75"
"101515","6","6","6","0","3","1.75"
"102196","13","13","13","0","8","1.75"
"102322","17","17","15","2","10","1.75"
"102607","12","12","10","2","8","1.75"
"102898","8","8","7","1","4","1.75"
"103123","9","9","9","0","6","1.75"
"103215","17","17","14","3","11","1.75"
"103624","13","13","12","1","11","1.75"
"103857","5","5","5","0","4","1.75"
"103993","12","12","11","1","6","1.75"
"104054","11","11","11","0","5","1.75"
"104125","17","17","16","1","11","1.75"
"104776","15","15","13","2","11","1.75"
"105275","13","13","11","2","7","1.75"
"105970","8","8","8","0","4","1.75"
"106128","13","13","9","4","7","1.75"
"106756","12","12","12","0","8","1.75"
"107394","12","12","11","1","6","1.75"
"107633","12","12","11","1","6","1.75"
"107994","12","12","11","1","6","1.75"
"108363","13","13","11","2","6","1.75"
"109699","15","15","13","2","5","1.75"
"110054","10","10","10","0","5","1.75"
"110389","7","7","6","1","3","1.75"
"110560","16","16","15","1","8","1.75"
"110678","11","11","10","1","8","1.75"
"110781","14","14","14","0","7","1.75"
"111424","16","16","14","2","9","1.75"
"111526","10","10","9","1","6","1.75"
"112170","10","10","8","2","6","1.75"
"112477","10","10","7","3","5","1.75"
"112518","12","12","11","1","6","1.75"
"112739","9","9","8","1","4","1.75"
"112780","9","9","8","1","4","1.75"
"112844","9","9","9","0","4","1.75"
"112935","13","13","11","2","6","1.75"
"113579","13","13","11","2","4","1.75"
"113675","9","9","6","3","4","1.75"
"113793","11","11","10","1","5","1.75"
"114139","13","13","13","0","5","1.75"
"114438","7","7","7","0","4","1.75"
"114542","8","8","8","0","5","1.75"
"114590","7","7","7","0","4","1.75"
"114601","11","11","7","4","4","1.75"
"114884","16","16","15","1","7","1.75"
"115624","11","11","9","2","4","1.75"
"115699","16","16","15","1","12","1.75"
"115757","18","18","15","3","9","1.75"
"115981","8","8","6","2","4","1.75"
"116058","11","11","9","2","6","1.75"
"116513","16","16","13","3","12","1.75"
"116892","11","11","10","1","9","1.75"
"117345","17","17","13","4","7","1.75"
"117472","9","9","9","0","6","1.75"
"105312","14","14","14","0","10","1.74"
"101476","14","14","14","0","7","1.73"
"105029","19","19","17","2","15","1.72"
"106732","18","18","16","2","9","1.72"
"107044","18","18","16","2","12","1.72"
"108580","17","17","15","2","11","1.72"
"110075","16","16","13","3","9","1.72"
"110286","12","12","11","1","9","1.72"
"111960","17","17","15","2","8","1.72"
"114557","17","17","15","2","11","1.72"
"100406","13","13","10","3","8","1.71"
"101178","13","13","9","4","8","1.71"
"101928","17","17","15","2","9","1.71"
"115336","17","17","16","1","9","1.71"
"115433","16","16","15","1","10","1.71"
"102269","12","12","11","1","7","1.70"
"103433","12","12","12","0","8","1.70"
"103809","16","16","14","2","9","1.70"
"105254","8","8","8","0","6","1.70"
"106179","15","15","12","3","7","1.70"
"109081","12","12","11","1","8","1.70"
"109735","16","16","14","2","9","1.70"
"109780","21","21","19","2","10","1.70"
"111694","10","10","10","0","8","1.70"
"111753","12","12","10","2","6","1.70"
"114896","16","16","15","1","13","1.70"
"115938","11","11","11","0","7","1.70"
"116779","15","15","14","1","10","1.70"
"102488","12","12","10","2","7","1.69"
"106617","15","15","13","2","11","1.69"
"107354","15","15","14","1","9","1.69"
"107383","15","15","14","1","11","1.69"
"113482","16","16","14","2","11","1.69"
"113892","13","13","10","3","8","1.69"
"115289","18","18","14","4","12","1.69"
"116004","14","14","14","0","11","1.69"
"116218","17","17","15","2","10","1.69"
"100182","6","6","5","1","5","1.67"
"100545","9","9","9","0","3","1.67"
"101399","26","26","23","3","15","1.67"
"101826","13","13","12","1","7","1.67"
"102020","13","13","11","2","4","1.67"
"102062","14","14","12","2","8","1.67"
"102174","9","9","8","1","7","1.67"
"102326","13","13","12","1","10","1.67"
"103350","16","16","14","2","7","1.67"
"104101","8","8","8","0","4","1.67"
"104130","17","17","13","4","10","1.67"
"104248","12","12","11","1","3","1.67"
"104263","9","9","7","2","7","1.67"
"104429","16","16","15","1","9","1.67"
"104450","6","6","6","0","3","1.67"
"104496","9","9","9","0","7","1.67"
"105004","16","16","13","3","7","1.67"
"106457","19","19","18","1","12","1.67"
"106496","13","13","9","4","4","1.67"
"106608","14","14","12","2","7","1.67"
"106683","12","12","11","1","4","1.67"
"108485","12","12","9","3","3","1.67"
"109301","11","11","11","0","3","1.67"
"109383","11","11","10","1","7","1.67"
"110044","11","11","10","1","3","1.67"
"111204","12","12","11","1","9","1.67"
"112189","9","9","7","2","4","1.67"
"113126","7","7","7","0","4","1.67"
"113226","10","10","9","1","5","1.67"
"113434","11","11","11","0","9","1.67"
"114342","9","9","7","2","4","1.67"
"114513","9","9","6","3","3","1.67"
"115807","4","4","4","0","4","1.67"
"116166","11","11","9","2","3","1.67"
"116349","11","11","10","1","8","1.67"
"116991","19","19","16","3","6","1.67"
"117061","12","12","12","0","6","1.67"
"100172","19","19","17","2","12","1.64"
"100444","20","20","19","1","13","1.64"
"105081","16","16","11","5","9","1.64"
"105731","13","13","12","1","9","1.64"
"106784","13","13","12","1","10","1.64"
"102629","12","12","11","1","9","1.63"
"104267","11","11","9","2","7","1.63"
"105185","8","8","7","1","5","1.63"
"108003","12","12","8","4","6","1.63"
"110002","8","8","6","2","5","1.63"
"113620","12","12","12","0","8","1.63"
"116140","16","16","13","3","8","1.63"
"103426","15","15","14","1","11","1.62"
"105043","15","15","14","1","11","1.62"
"107571","17","17","16","1","9","1.62"
"114116","14","14","11","3","9","1.62"
"100323","11","11","10","1","6","1.60"
"100528","15","15","11","4","7","1.60"
"101912","12","12","11","1","9","1.60"
"102042","13","13","12","1","6","1.60"
"102612","11","11","11","0","8","1.60"
"102831","28","28","27","1","16","1.60"
"102944","10","10","8","2","5","1.60"
"103464","10","10","9","1","7","1.60"
"103694","14","14","13","1","9","1.60"
"103999","6","6","6","0","5","1.60"
"104967","14","14","11","3","6","1.60"
"106894","12","12","10","2","9","1.60"
"108177","8","8","7","1","6","1.60"
"110603","7","7","5","2","5","1.60"
"110851","10","10","9","1","6","1.60"
"113446","13","13","12","1","6","1.60"
"116457","10","10","10","0","5","1.60"
"116588","10","10","10","0","7","1.60"
"116703","8","8","6","2","5","1.60"
"100165","12","12","12","0","7","1.58"
"100562","15","15","14","1","8","1.58"
"101274","14","14","13","1","8","1.58"
"102968","14","14","12","2","8","1.58"
"103985","17","17","15","2","10","1.58"
"105668","15","15","14","1","8","1.58"
"109294","16","16","14","2","6","1.58"
"103641","13","13","13","0","7","1.57"
"107315","17","17","14","3","9","1.57"
"109804","11","11","10","1","8","1.57"
"109835","13","13","11","2","8","1.57"
"102225","9","9","8","1","5","1.56"
"107245","13","13","11","2","9","1.56"
"111362","12","12","11","1","9","1.56"
"113645","13","13","11","2","9","1.56"
"115642","9","9","9","0","6","1.56"
"104036","15","15","13","2","9","1.55"
"108055","15","15","13","2","9","1.55"
"113321","12","12","10","2","8","1.55"
"101531","12","12","9","3","7","1.53"
"103885","12","12","11","1","8","1.53"
"113847","12","12","11","1","7","1.53"
"100005","5","5","5","0","3","1.50"
"100149","10","10","9","1","6","1.50"
"100504","6","6","4","2","4","1.50"
"100571","10","10","9","1","4","1.50"
"100665","8","8","8","0","3","1.50"
"100720","10","10","10","0","9","1.50"
"100972","9","9","6","3","2","1.50"
"101230","6","6","5","1","5","1.50"
"101939","11","11","11","0","7","1.50"
"101968","9","9","9","0","4","1.50"
"103168","10","10","8","2","8","1.50"
"103363","10","10","8","2","3","1.50"
"103439","9","9","8","1","6","1.50"
"104393","5","5","5","0","2","1.50"
"104399","12","12","10","2","6","1.50"
"104685","10","10","8","2","2","1.50"
"104822","12","12","11","1","6","1.50"
"105544","13","13","12","1","6","1.50"
"106174","11","11","10","1","8","1.50"
"106668","13","13","12","1","4","1.50"
"106746","6","6","4","2","2","1.50"
"106783","9","9","6","3","2","1.50"
"107387","15","15","14","1","7","1.50"
"107507","15","15","14","1","9","1.50"
"107508","11","11","11","0","5","1.50"
"108145","11","11","8","3","3","1.50"
"108163","9","9","7","2","4","1.50"
"108233","11","11","10","1","6","1.50"
"108295","12","12","11","1","7","1.50"
"108468","13","13","13","0","7","1.50"
"109105","11","11","9","2","3","1.50"
"109209","5","5","4","1","4","1.50"
"109731","11","11","11","0","6","1.50"
"110015","18","18","18","0","9","1.50"
"110589","5","5","3","2","2","1.50"
"111566","16","16","14","2","9","1.50"
"111705","12","12","12","0","7","1.50"
"111731","7","7","6","1","4","1.50"
"111988","10","10","9","1","8","1.50"
"112451","6","6","4","2","2","1.50"
"112499","13","13","12","1","4","1.50"
"112952","12","12","11","1","9","1.50"
"113669","12","12","6","6","2","1.50"
"113761","16","16","16","0","10","1.50"
"113834","12","12","10","2","8","1.50"
"114552","7","7","5","2","3","1.50"
"115122","13","13","11","2","8","1.50"
"115916","9","9","6","3","2","1.50"
"116181","8","8","7","1","4","1.50"
"116686","10","10","8","2","4","1.50"
"117222","13","13","10","3","6","1.50"
"114753","21","21","20","1","14","1.48"
"116075","11","11","11","0","9","1.48"
"110753","13","13","11","2","8","1.45"
"113927","15","15","15","0","9","1.45"
"106092","12","12","12","0","9","1.43"
"113573","14","14","13","1","11","1.43"
"113681","17","17","15","2","12","1.43"
"100380","13","13","13","0","8","1.42"
"100823","12","12","11","1","7","1.42"
"101332","12","12","10","2","6","1.42"
"102767","10","10","10","0","6","1.42"
"105297","9","9","8","1","6","1.42"
"105820","13","13","12","1","7","1.42"
"114025","16","16","13","3","7","1.42"
"117005","10","10","8","2","6","1.42"
"102413","13","13","13","0","9","1.40"
"102893","10","10","8","2","5","1.40"
"106054","17","17","15","2","6","1.40"
"110612","16","16","13","3","8","1.40"
"112519","11","11","11","0","6","1.40"
"101744","12","12","12","0","5","1.38"
"102606","6","6","6","0","5","1.38"
"104470","12","12","10","2","5","1.38"
"104930","9","9","8","1","5","1.38"
"112790","11","11","7","4","5","1.38"
"104744","12","12","12","0","9","1.36"
"112103","16","16","15","1","9","1.36"
"115588","14","14","14","0","8","1.36"
"108496","6","6","5","1","4","1.34"
"100214","18","18","17","1","11","1.33"
"101331","15","15","14","1","8","1.33"
"101444","7","7","6","1","3","1.33"
"102423","7","7","5","2","3","1.33"
"103315","12","12","7","5","5","1.33"
"104260","8","8","7","1","4","1.33"
"105248","6","6","3","3","3","1.33"
"107467","8","8","6","2","3","1.33"
"107540","6","6","4","2","3","1.33"
"109899","9","9","8","1","4","1.33"
"110728","6","6","6","0","3","1.33"
"110957","10","9","8","2","4","1.33"
"115072","9","9","8","1","3","1.33"
"116681","10","10","8","2","3","1.33"
"116835","11","11","9","2","3","1.33"
"109420","11","11","8","3","7","1.31"
"110351","10","10","8","2","8","1.31"
"111110","9","9","9","0","7","1.31"
"104692","12","12","10","2","8","1.30"
"116774","11","11","11","0","6","1.30"
"108060","15","15","15","0","8","1.29"
"109617","17","17","14","3","8","1.29"
"110613","12","12","12","0","8","1.27"
"100471","9","9","8","1","4","1.25"
"100855","12","12","10","2","5","1.25"
"101005","9","9","7","2","6","1.25"
"101567","9","9","8","1","4","1.25"
"104815","6","6","4","2","4","1.25"
"109776","10","10","9","1","7","1.25"
"110232","10","10","8","2","4","1.25"
"110619","11","11","10","1","4","1.25"
"112977","9","9","7","2","4","1.25"
"114004","6","6","5","1","3","1.25"
"115153","11","11","9","2","6","1.25"
"101491","10","10","9","1","6","1.20"
"103180","9","9","8","1","6","1.20"
"109243","15","15","13","2","5","1.20"
"111972","12","12","9","3","6","1.20"
"112337","10","10","9","1","5","1.20"
"113147","9","9","8","1","6","1.20"
"117030","14","14","11","3","6","1.20"
"103683","9","9","8","1","4","1.17"
"107640","6","6","6","0","4","1.17"
"114246","12","12","11","1","5","1.17"
"116607","15","15","11","4","9","1.17"
"102426","9","9","9","0","5","1.13"
"102523","12","12","10","2","9","1.13"
"105399","10","10","8","2","6","1.13"
"106831","11","11","10","1","5","1.13"
"100068","2","2","2","0","2","1.00"
"100320","9","9","8","1","2","1.00"
"100517","8","8","5","3","2","1.00"
"100588","6","6","5","1","2","1.00"
"100820","9","9","7","2","2","1.00"
"101089","8","8","7","1","3","1.00"
"101999","8","8","6","2","3","1.00"
"102482","4","4","3","1","1","1.00"
"103111","10","10","10","0","5","1.00"
"103140","6","6","6","0","2","1.00"
"103224","13","13","10","3","6","1.00"
"103940","13","13","12","1","3","1.00"
"104171","9","9","8","1","5","1.00"
"104535","3","3","2","1","1","1.00"
"104925","7","7","6","1","4","1.00"
"105359","15","15","13","2","4","1.00"
"106096","8","8","8","0","5","1.00"
"107446","6","6","5","1","4","1.00"
"107757","8","8","7","1","2","1.00"
"108243","7","7","7","0","4","1.00"
"108258","9","9","8","1","5","1.00"
"108563","8","8","6","2","5","1.00"
"108787","7","7","5","2","2","1.00"
"109333","8","8","7","1","6","1.00"
"109602","6","6","6","0","3","1.00"
"110289","6","6","5","1","4","1.00"
"111056","8","8","7","1","3","1.00"
"111117","13","13","11","2","4","1.00"
"111455","7","7","5","2","3","1.00"
"111898","8","8","6","2","2","1.00"
"112970","6","6","5","1","1","1.00"
"113584","11","11","9","2","1","1.00"
"114118","8","8","8","0","3","1.00"
"114240","13","13","12","1","7","1.00"
"114302","6","6","3","3","2","1.00"
"115069","12","12","10","2","3","1.00"
"115416","12","12","8","4","3","1.00"
"116053","9","9","8","1","3","1.00"
"116440","6","6","4","2","3","1.00"
"117266","8","8","5","3","2","1.00"
"117590","6","6","6","0","3","1.00"
"110336","2","2","1","1","0",""
"111114","3","3","1","2","0",""
"","137098","6173","0","137098","0",""